% 	%google-translate-at-point
%google-translate-default-ui-read-from-minibuffer
%google-translate-query-translate 	*
+ 	-
/ 	/=
1+ 	1-
1value 	2C-associate-buffer
2C-command 	2C-split
2C-two-columns 	5x5
5x5-crack 	5x5-crack-mutating-best
5x5-crack-mutating-current 	5x5-crack-randomly
5x5-crack-xor-mutate 	<
<= 	=
> 	>=
Buffer-menu--pretty-file-name 	Buffer-menu--pretty-name
Buffer-menu--unmark 	Buffer-menu-1-window
Buffer-menu-2-window 	Buffer-menu-backup-unmark
Buffer-menu-beginning 	Buffer-menu-buffer
Buffer-menu-bury 	Buffer-menu-delete
Buffer-menu-delete-backwards 	Buffer-menu-execute
Buffer-menu-info-node-description 	Buffer-menu-isearch-buffers
Buffer-menu-isearch-buffers-regexp 	Buffer-menu-mark
Buffer-menu-marked-buffers 	Buffer-menu-mode
Buffer-menu-mouse-select 	Buffer-menu-multi-occur
Buffer-menu-no-header 	Buffer-menu-not-modified
Buffer-menu-other-window 	Buffer-menu-save
Buffer-menu-select 	Buffer-menu-sort
Buffer-menu-switch-other-window 	Buffer-menu-this-window
Buffer-menu-toggle-files-only 	Buffer-menu-toggle-read-only
Buffer-menu-unmark 	Buffer-menu-view
Buffer-menu-view-other-window 	Buffer-menu-visit-tags-table
Control-X-prefix 	ESC-prefix
Electric-command-history-redo-expression
Electric-command-loop 	Electric-pop-up-window
Helper-describe-bindings 	Helper-help
Info-bookmark-jump 	Info-directory
Info-goto-emacs-command-node 	Info-goto-emacs-key-command-node
Info-index 	Info-mode
Info-on-current-buffer 	Info-speedbar-browser
Info-split 	Info-tagify
Info-validate 	LaTeX-mode
Man-bookmark-jump 	Snarf-documentation
TeX-mode 	View-exit-and-edit
` 	abbrev--active-tables
abbrev--before-point 	abbrev--check-chars
abbrev--default-expand 	abbrev--describe
abbrev--symbol 	abbrev--write
abbrev-edit-save-buffer 	abbrev-edit-save-to-file
abbrev-expansion 	abbrev-get
abbrev-insert 	abbrev-mode
abbrev-prefix-mark 	abbrev-put
abbrev-symbol 	abbrev-table-empty-p
abbrev-table-get 	abbrev-table-menu
abbrev-table-name 	abbrev-table-p
abbrev-table-put 	abbreviate-file-name
abort-if-file-too-large 	abort-recursive-edit
about-emacs 	abs
ac-config-default 	accelerate-menu
accept-change-group 	accept-process-output
access-file 	accessible-keymaps
acos 	activate-change-group
activate-input-method 	activate-mark
active-minibuffer-window 	ad-activate
ad-add-advice 	ad-disable-advice
ad-enable-advice 	ada-add-extensions
ada-find-file 	ada-header
ada-mode 	add-abbrev
add-change-log-entry 	add-change-log-entry-other-window
add-dir-local-variable 	add-face-text-property
add-file-local-variable 	add-file-local-variable-prop-line
add-function 	add-global-abbrev
add-hook 	add-log-current-defun
add-minor-mode 	add-mode-abbrev
add-name-to-file 	add-submenu
add-text-properties 	add-timeout
add-to-coding-system-list 	add-to-history
add-to-invisibility-spec 	add-to-list
add-to-ordered-list 	adjust-window-trailing-edge
advertised-undo 	advice--add-function
advice--buffer-local 	advice--called-interactively-skip
advice--car 	advice--cd*r
advice--cdr 	advice--defalias-fset
advice--interactive-form 	advice--make
advice--make-1 	advice--make-docstring
advice--make-interactive-form 	advice--member-p
advice--normalize 	advice--normalize-place
advice--p 	advice--props
advice--remove-function 	advice--set-buffer-local
advice--strip-macro 	advice--subst-main
advice--symbol-function 	advice--tweak
advice-add 	advice-eval-interactive-spec
advice-function-mapc 	advice-function-member-p
advice-mapc 	advice-member-p
advice-remove 	after-find-file
after-insert-file-set-coding 	align
align-current 	align-entire
align-highlight-rule 	align-newline-and-indent
align-regexp 	align-unhighlight-rule
all-completions 	allout-auto-activation-helper
allout-mode 	allout-mode-p
allout-setup 	allout-widgets-mode
allout-widgets-setup 	alter-text-property
and 	ange-ftp-completion-hook-function
ange-ftp-hook-function 	ange-ftp-re-read-dir
ange-ftp-reread-dir 	animate-birthday-present
animate-sequence 	animate-string
ansi-color-for-comint-mode-on 	ansi-color-process-output
ansi-term 	antlr-mode
antlr-set-tabs 	antlr-show-makefile-rules
append 	append-next-kill
append-to-buffer 	append-to-file
append-to-register 	apply
apply-macro-to-region-lines 	apply-partially
appt-activate 	appt-add
apropos 	apropos-command
apropos-documentation 	apropos-documentation-property
apropos-internal 	apropos-library
apropos-read-pattern 	apropos-user-option
apropos-value 	apropos-variable
archive-mode 	aref
arp 	array-mode
arrayp 	artist-mode
aset 	ash
asin 	ask-user-about-lock
ask-user-about-supersession-threat 	asm-mode
assoc 	assoc-default
assoc-ignore-case 	assoc-ignore-representation
assoc-string 	assq
assq-delete-all 	async-shell-command
atan 	atom
atomic-change-group 	auth-source--aget
auth-source--aput 	auth-source--aput-1
auth-source-backend 	auth-source-backend-child-p
auth-source-backend-list-p 	auth-source-backend-p
auth-source-backend-parse 	auth-source-backend-parse-parameters
auth-source-current-line 	auth-source-delete
auth-source-do-debug 	auth-source-do-trivia
auth-source-do-warn 	auth-source-ensure-strings
auth-source-epa-extract-gpg-token 	auth-source-epa-make-gpg-token
auth-source-forget 	auth-source-forget+
auth-source-forget-all-cached 	auth-source-format-cache-entry
auth-source-format-prompt 	auth-source-macos-keychain-create
auth-source-macos-keychain-result-append
auth-source-macos-keychain-search 	auth-source-macos-keychain-search-items
auth-source-netrc-create 	auth-source-netrc-element-or-first
auth-source-netrc-normalize 	auth-source-netrc-parse
auth-source-netrc-parse-entries 	auth-source-netrc-parse-next-interesting
auth-source-netrc-parse-one 	auth-source-netrc-saver
auth-source-netrc-search 	auth-source-pick-first-password
auth-source-plstore-create 	auth-source-plstore-search
auth-source-read-char-choice 	auth-source-recall
auth-source-remember 	auth-source-remembered-p
auth-source-search 	auth-source-search-backends
auth-source-search-collection 	auth-source-secrets-create
auth-source-secrets-listify-pattern 	auth-source-secrets-search
auth-source-specmatchp
auth-source-token-passphrase-callback-function
auth-source-user-and-password 	auth-source-user-or-password
auto-coding-alist-lookup 	auto-coding-regexp-alist-lookup
auto-complete 	auto-complete-mode
auto-compose-chars 	auto-composition-mode
auto-compression-mode 	auto-encryption-mode
auto-fill-function 	auto-fill-mode
auto-image-file-mode 	auto-insert
auto-insert-mode 	auto-lower-mode
auto-raise-mode 	auto-revert-mode
auto-revert-tail-mode 	auto-save-file-name-p
auto-save-mode 	autoarg-kp-mode
autoarg-mode 	autoconf-mode
autoload 	autoload-coding-system
autoload-do-load 	autoloadp
awk-mode 	back-to-indentation
background-color-at-point 	backquote
backquote-delay-process 	backquote-list*
backquote-list*-function 	backquote-list*-macro
backquote-listify 	backquote-process
backtrace 	backtrace--locals
backtrace-debug 	backtrace-eval
backtrace-frame 	backup-buffer
backup-buffer-copy 	backup-extract-version
backup-file-name-p 	backward-button
backward-char 	backward-delete-char
backward-delete-char-untabify 	backward-kill-paragraph
backward-kill-sentence 	backward-kill-sexp
backward-kill-word 	backward-list
backward-page 	backward-paragraph
backward-prefix-chars 	backward-sentence
backward-sexp 	backward-to-indentation
backward-up-list 	backward-word
bad-package-check 	balance-windows
balance-windows-1 	balance-windows-2
balance-windows-area 	balance-windows-area-adjust
barf-if-buffer-read-only 	base64-decode-region
base64-decode-string 	base64-encode-region
base64-encode-string 	basic-save-buffer
basic-save-buffer-1 	basic-save-buffer-2
bat-mode 	batch-byte-compile
batch-byte-compile-file 	batch-byte-compile-if-not-done
batch-byte-recompile-directory 	batch-info-validate
batch-titdic-convert 	batch-unrmail
batch-update-autoloads 	battery
beep 	beginning-of-buffer
beginning-of-buffer-other-window 	beginning-of-defun
beginning-of-defun-raw 	beginning-of-line
beginning-of-line-text 	beginning-of-visual-line
benchmark 	benchmark-run
benchmark-run-compiled 	bibtex-initialize
bibtex-mode 	bibtex-search-entry
bibtex-style-mode 	bidi-string-mark-left-to-right
binary-overwrite-mode 	bindings--define-key
binhex-decode-region 	binhex-decode-region-external
binhex-decode-region-internal 	bitmap-spec-p
blackbox 	blink-cursor-check
blink-cursor-end 	blink-cursor-mode
blink-cursor-start 	blink-cursor-suspend
blink-cursor-timer-function 	blink-matching-check-mismatch
blink-matching-open 	blink-paren-post-self-insert-function
bobp 	bolp
bookmark-bmenu-list 	bookmark-bmenu-search
bookmark-delete 	bookmark-insert
bookmark-insert-location 	bookmark-jump
bookmark-jump-other-window 	bookmark-load
bookmark-locate 	bookmark-map
bookmark-relocate 	bookmark-rename
bookmark-save 	bookmark-set
bookmark-write 	bool-vector-count-consecutive
bool-vector-count-population 	bool-vector-exclusive-or
bool-vector-intersection 	bool-vector-not
bool-vector-p 	bool-vector-set-difference
bool-vector-subsetp 	bool-vector-union
booleanp 	bound-and-true-p
boundp 	bounds-of-thing-at-point
bovine-grammar-mode 	browse-url
browse-url-at-mouse 	browse-url-at-point
browse-url-cci 	browse-url-chromium
browse-url-elinks 	browse-url-emacs
browse-url-firefox 	browse-url-galeon
browse-url-generic 	browse-url-gnome-moz
browse-url-kde 	browse-url-mail
browse-url-mosaic 	browse-url-mozilla
browse-url-netscape 	browse-url-of-buffer
browse-url-of-dired-file 	browse-url-of-file
browse-url-of-region 	browse-url-text-emacs
browse-url-text-xterm 	browse-url-w3
browse-url-w3-gnudoit 	browse-url-xdg-open
browse-web 	bs-customize
bs-cycle-next 	bs-cycle-previous
bs-show 	bubbles
buffer-base-buffer 	buffer-chars-modified-tick
buffer-disable-undo 	buffer-enable-undo
buffer-end 	buffer-face-mode
buffer-face-set 	buffer-face-toggle
buffer-file-name 	buffer-has-markers-at
buffer-list 	buffer-live-p
buffer-local-value 	buffer-local-variables
buffer-menu 	buffer-menu-other-window
buffer-modified-p 	buffer-modified-tick
buffer-name 	buffer-narrowed-p
buffer-size 	buffer-stale--default-function
buffer-string 	buffer-substring
buffer-substring--filter 	buffer-substring-no-properties
buffer-swap-text 	bufferp
bug-reference-mode 	bug-reference-prog-mode
build-mail-abbrevs 	bury-buffer
bury-buffer-internal 	butlast
butterfly 	button--area-button-p
button--area-button-string 	button-activate
button-at 	button-category-symbol
button-end 	button-get
button-has-type-p 	button-label
button-put 	button-start
button-type 	button-type-get
button-type-put 	button-type-subtype-p
byte-code 	byte-code-function-p
byte-compile 	byte-compile--declare-var
byte-compile--reify-function 	byte-compile-abbreviate-file
byte-compile-and 	byte-compile-and-folded
byte-compile-and-recursion 	byte-compile-annotate-call-tree
byte-compile-arglist-signature 	byte-compile-arglist-signature-string
byte-compile-arglist-signatures-congruent-p
byte-compile-arglist-vars 	byte-compile-arglist-warn
byte-compile-associative 	byte-compile-autoload
byte-compile-backward-char 	byte-compile-backward-word
byte-compile-bind 	byte-compile-body
byte-compile-body-do-effect 	byte-compile-butlast
byte-compile-callargs-warn 	byte-compile-catch
byte-compile-char-before 	byte-compile-check-lambda-list
byte-compile-check-variable 	byte-compile-cl-file-p
byte-compile-cl-warn 	byte-compile-close-variables
byte-compile-concat 	byte-compile-cond
byte-compile-condition-case 	byte-compile-condition-case--new
byte-compile-condition-case--old 	byte-compile-constant
byte-compile-constants-vector 	byte-compile-defvar
byte-compile-delete-first 	byte-compile-dest-file
byte-compile-disable-warning 	byte-compile-discard
byte-compile-dynamic-variable-bind 	byte-compile-dynamic-variable-op
byte-compile-enable-warning 	byte-compile-eval
byte-compile-eval-before-compile 	byte-compile-fdefinition
byte-compile-file 	byte-compile-file-form
byte-compile-file-form-autoload
byte-compile-file-form-custom-declare-variable
byte-compile-file-form-defalias
byte-compile-file-form-define-abbrev-table
byte-compile-file-form-defmumble 	byte-compile-file-form-defvar
byte-compile-file-form-eval 	byte-compile-file-form-progn
byte-compile-file-form-require 	byte-compile-file-form-with-no-warnings
byte-compile-find-bound-condition 	byte-compile-find-cl-functions
byte-compile-fix-header 	byte-compile-flush-pending
byte-compile-form 	byte-compile-form-do-effect
byte-compile-form-make-variable-buffer-local
byte-compile-format-warn 	byte-compile-from-buffer
byte-compile-fset 	byte-compile-funcall
byte-compile-function-form 	byte-compile-function-warn
byte-compile-get-closed-var 	byte-compile-get-constant
byte-compile-goto 	byte-compile-goto-if
byte-compile-if 	byte-compile-indent-to
byte-compile-inline-expand 	byte-compile-inline-lapcode
byte-compile-insert 	byte-compile-insert-header
byte-compile-keep-pending 	byte-compile-lambda
byte-compile-lambda-form 	byte-compile-lapcode
byte-compile-let 	byte-compile-list
byte-compile-log 	byte-compile-log-1
byte-compile-log-file 	byte-compile-log-lap
byte-compile-log-lap-1 	byte-compile-log-warning
byte-compile-macroexpand-declare-function
byte-compile-make-args-desc 	byte-compile-make-closure
byte-compile-make-lambda-lexenv 	byte-compile-make-obsolete-variable
byte-compile-make-tag 	byte-compile-make-variable-buffer-local
byte-compile-maybe-guarded 	byte-compile-minus
byte-compile-nconc 	byte-compile-negated
byte-compile-negation-optimizer 	byte-compile-nilconstp
byte-compile-no-args 	byte-compile-no-warnings
byte-compile-nogroup-warn 	byte-compile-noop
byte-compile-normal-call 	byte-compile-not-lexical-var-p
byte-compile-one-arg 	byte-compile-one-or-two-args
byte-compile-or 	byte-compile-or-recursion
byte-compile-out 	byte-compile-out-tag
byte-compile-out-toplevel 	byte-compile-output-as-comment
byte-compile-output-docform 	byte-compile-output-file-form
byte-compile-preprocess 	byte-compile-print-syms
byte-compile-prog1 	byte-compile-prog2
byte-compile-progn 	byte-compile-push-binding-init
byte-compile-push-bytecode-const2 	byte-compile-push-bytecodes
byte-compile-push-constant 	byte-compile-quo
byte-compile-quote 	byte-compile-refresh-preloaded
byte-compile-report-error 	byte-compile-report-ops
byte-compile-save-current-buffer 	byte-compile-save-excursion
byte-compile-save-restriction 	byte-compile-set-default
byte-compile-set-symbol-position 	byte-compile-setq
byte-compile-setq-default 	byte-compile-sexp
byte-compile-stack-adjustment 	byte-compile-stack-ref
byte-compile-stack-set 	byte-compile-subr-wrong-args
byte-compile-three-args 	byte-compile-top-level
byte-compile-top-level-body 	byte-compile-toplevel-file-form
byte-compile-track-mouse 	byte-compile-trueconstp
byte-compile-two-args 	byte-compile-two-or-three-args
byte-compile-unbind 	byte-compile-unfold-bcf
byte-compile-unfold-lambda 	byte-compile-unwind-protect
byte-compile-variable-ref 	byte-compile-variable-set
byte-compile-warn
byte-compile-warn-about-unresolved-functions
byte-compile-warn-obsolete 	byte-compile-warning-enabled-p
byte-compile-warning-prefix 	byte-compile-warning-series
byte-compile-while 	byte-compile-zero-or-one-arg
byte-compiler-base-file-name 	byte-decompile-bytecode
byte-decompile-bytecode-1 	byte-defop
byte-defop-compiler 	byte-defop-compiler-1
byte-extrude-byte-code-vectors 	byte-force-recompile
byte-optimize-all-constp 	byte-optimize-and
byte-optimize-apply 	byte-optimize-approx-equal
byte-optimize-associative-math 	byte-optimize-binary-predicate
byte-optimize-body 	byte-optimize-cond
byte-optimize-delay-constants-math 	byte-optimize-divide
byte-optimize-form 	byte-optimize-form-code-walker
byte-optimize-funcall 	byte-optimize-identity
byte-optimize-if 	byte-optimize-inline-handler
byte-optimize-lapcode 	byte-optimize-letX
byte-optimize-logmumble 	byte-optimize-minus
byte-optimize-multiply 	byte-optimize-nonassociative-math
byte-optimize-nth 	byte-optimize-nthcdr
byte-optimize-or 	byte-optimize-plus
byte-optimize-predicate 	byte-optimize-quote
byte-optimize-set 	byte-optimize-while
byte-optimize-zerop 	byte-recompile-directory
byte-recompile-file 	byte-to-position
byte-to-string 	byteorder
c++-mode 	c-add-style
c-guess 	c-guess-basic-syntax
c-guess-buffer 	c-guess-buffer-no-install
c-guess-install 	c-guess-no-install
c-guess-region 	c-guess-region-no-install
c-initialize-cc-mode 	c-macro-expand
c-mode 	c-set-offset
c-set-style 	caar
cadr 	calc
calc-dispatch 	calc-embedded
calc-embedded-activate 	calc-eval
calc-grab-rectangle 	calc-grab-region
calc-keypad 	calc-undo
calculate-lisp-indent 	calculator
calendar 	calendar-hebrew-list-yahrzeits
call-interactively 	call-last-kbd-macro
call-next-method 	call-process
call-process-region 	call-process-shell-command
called-interactively-p 	cancel-change-group
cancel-debug-on-entry 	cancel-function-timers
cancel-kbd-macro-events 	cancel-timer
cancel-timer-internal 	canlock-insert-header
canlock-verify 	canonicalize-coding-system-name
canonically-space-region 	capitalize
capitalize-region 	capitalize-word
capitalized-words-mode 	car
car-less-than-car 	car-safe
case-table-get-table 	case-table-p
catch 	category-docstring
category-set-mnemonics 	category-table
category-table-p 	ccl-compile
ccl-dump 	ccl-execute
ccl-execute-on-string 	ccl-execute-with-args
ccl-program-p 	cconv--analyse-function
cconv--analyse-use 	cconv--convert-function
cconv--map-diff 	cconv--map-diff-elem
cconv--map-diff-set 	cconv--set-diff
cconv--set-diff-map 	cconv-analyse-form
cconv-closure-convert 	cconv-convert
cconv-warnings-only 	cd
cd-absolute 	cdar
cddr 	cdr
cdr-safe 	ceiling
center-line 	center-paragraph
center-region 	cfengine-auto-mode
cfengine2-mode 	cfengine3-mode
change-class 	change-log-merge
change-log-mode 	char-after
char-before 	char-category-set
char-charset 	char-code-property-description
char-displayable-p 	char-equal
char-or-string-p 	char-resolve-modifiers
char-syntax 	char-table-extra-slot
char-table-p 	char-table-parent
char-table-range 	char-table-subtype
char-to-string 	char-valid-p
char-width 	characterp
charset-after 	charset-bytes
charset-chars 	charset-description
charset-dimension 	charset-id
charset-id-internal 	charset-info
charset-iso-final-char 	charset-list
charset-long-name 	charset-plist
charset-priority-list 	charset-short-name
charsetp 	check-ccl-program
check-coding-system 	check-coding-systems-region
check-declare-directory 	check-declare-file
check-face 	check-parens
checkdoc 	checkdoc-comments
checkdoc-continue 	checkdoc-current-buffer
checkdoc-defun 	checkdoc-eval-current-buffer
checkdoc-eval-defun 	checkdoc-interactive
checkdoc-ispell 	checkdoc-ispell-comments
checkdoc-ispell-continue 	checkdoc-ispell-current-buffer
checkdoc-ispell-defun 	checkdoc-ispell-interactive
checkdoc-ispell-message-interactive 	checkdoc-ispell-message-text
checkdoc-ispell-start 	checkdoc-list-of-strings-p
checkdoc-message-interactive 	checkdoc-message-text
checkdoc-minor-mode 	checkdoc-rogue-spaces
checkdoc-start 	child-of-class-p
chmod 	choose-completion
choose-completion-delete-max-match 	choose-completion-guess-base-position
choose-completion-string 	cl--adjoin
cl--block-throw 	cl--block-wrapper
cl--compiler-macro-adjoin 	cl--compiler-macro-cXXr
cl--compiler-macro-get 	cl--compiler-macro-list*
cl--compiling-file 	cl--defalias
cl--defsubst-expand 	cl--do-prettyprint
cl--do-remf 	cl--do-subst
cl--finite-do 	cl--map-intervals
cl--map-keymap-recursively 	cl--map-overlays
cl--mapcar-many 	cl--random-time
cl--set-buffer-substring 	cl--set-elt
cl--set-frame-visible-p 	cl--set-getf
cl--set-substring 	cl-acons
cl-adjoin 	cl-assert
cl-assoc 	cl-assoc-if
cl-assoc-if-not 	cl-block
cl-caaaar 	cl-caaadr
cl-caaar 	cl-caadar
cl-caaddr 	cl-caadr
cl-cadaar 	cl-cadadr
cl-cadar 	cl-caddar
cl-cadddr 	cl-caddr
cl-callf 	cl-callf2
cl-case 	cl-cdaaar
cl-cdaadr 	cl-cdaar
cl-cdadar 	cl-cdaddr
cl-cdadr 	cl-cddaar
cl-cddadr 	cl-cddar
cl-cdddar 	cl-cddddr
cl-cdddr 	cl-ceiling
cl-check-type 	cl-coerce
cl-compiler-macroexpand 	cl-concatenate
cl-copy-list 	cl-copy-seq
cl-count 	cl-count-if
cl-count-if-not 	cl-decf
cl-declaim 	cl-declare
cl-define-compiler-macro 	cl-defmacro
cl-defstruct 	cl-defsubst
cl-deftype 	cl-defun
cl-delete 	cl-delete-duplicates
cl-delete-if 	cl-delete-if-not
cl-destructuring-bind 	cl-do
cl-do* 	cl-do-all-symbols
cl-do-symbols 	cl-dolist
cl-dotimes 	cl-ecase
cl-eighth 	cl-endp
cl-equalp 	cl-etypecase
cl-eval-when 	cl-evenp
cl-every 	cl-fifth
cl-fill 	cl-find
cl-find-if 	cl-find-if-not
cl-first 	cl-flet
cl-flet* 	cl-float-limits
cl-floatp-safe 	cl-floor
cl-fourth 	cl-function
cl-gcd 	cl-gensym
cl-gentemp 	cl-get
cl-getf 	cl-incf
cl-intersection 	cl-isqrt
cl-labels 	cl-lcm
cl-ldiff 	cl-letf
cl-letf* 	cl-list*
cl-list-length 	cl-load-time-value
cl-locally 	cl-loop
cl-macrolet 	cl-make-random-state
cl-map 	cl-mapc
cl-mapcan 	cl-mapcar
cl-mapcon 	cl-mapl
cl-maplist 	cl-member
cl-member-if 	cl-member-if-not
cl-merge 	cl-minusp
cl-mismatch 	cl-mod
cl-multiple-value-apply 	cl-multiple-value-bind
cl-multiple-value-call 	cl-multiple-value-list
cl-multiple-value-setq 	cl-nintersection
cl-ninth 	cl-notany
cl-notevery 	cl-nreconc
cl-nset-difference 	cl-nset-exclusive-or
cl-nsublis 	cl-nsubst
cl-nsubst-if 	cl-nsubst-if-not
cl-nsubstitute 	cl-nsubstitute-if
cl-nsubstitute-if-not 	cl-nth-value
cl-nunion 	cl-oddp
cl-pairlis 	cl-plusp
cl-position 	cl-position-if
cl-position-if-not 	cl-prettyexpand
cl-prettyprint 	cl-proclaim
cl-progv 	cl-psetf
cl-psetq 	cl-pushnew
cl-random 	cl-random-state-p
cl-rassoc 	cl-rassoc-if
cl-rassoc-if-not 	cl-reduce
cl-rem 	cl-remf
cl-remove 	cl-remove-duplicates
cl-remove-if 	cl-remove-if-not
cl-remprop 	cl-replace
cl-rest 	cl-return
cl-return-from 	cl-revappend
cl-rotatef 	cl-round
cl-search 	cl-second
cl-set-difference 	cl-set-exclusive-or
cl-seventh 	cl-shiftf
cl-signum 	cl-sixth
cl-some 	cl-sort
cl-stable-sort 	cl-sublis
cl-subseq 	cl-subsetp
cl-subst 	cl-subst-if
cl-subst-if-not 	cl-substitute
cl-substitute-if 	cl-substitute-if-not
cl-svref 	cl-symbol-macrolet
cl-tagbody 	cl-tailp
cl-tenth 	cl-the
cl-third 	cl-tree-equal
cl-truncate 	cl-typecase
cl-typep 	cl-union
cl-values 	cl-values-list
class-abstract-p 	class-children
class-constructor 	class-direct-subclasses
class-direct-superclasses 	class-method-invocation-order
class-name 	class-of
class-option 	class-option-assoc
class-p 	class-parent
class-parents 	class-precedence-list
class-slot-initarg 	class-v
clean-buffer-list 	clear-abbrev-table
clear-buffer-auto-save-failure 	clear-charset-maps
clear-face-cache 	clear-font-cache
clear-image-cache 	clear-rectangle
clear-string 	clear-this-command-keys
clear-visited-file-modtime 	clipboard-kill-region
clipboard-kill-ring-save 	clipboard-yank
clone 	clone-buffer
clone-indirect-buffer 	clone-indirect-buffer-other-window
clone-process 	close-display-connection
close-font 	close-rectangle
clrhash 	coding-system-aliases
coding-system-base 	coding-system-category
coding-system-change-eol-conversion 	coding-system-change-text-conversion
coding-system-charset-list 	coding-system-doc-string
coding-system-eol-type 	coding-system-eol-type-mnemonic
coding-system-equal 	coding-system-from-name
coding-system-get 	coding-system-lessp
coding-system-list 	coding-system-mnemonic
coding-system-p 	coding-system-plist
coding-system-post-read-conversion 	coding-system-pre-write-conversion
coding-system-priority-list 	coding-system-put
coding-system-translation-table-for-decode
coding-system-translation-table-for-encode
coding-system-type 	collapse-delayed-warnings
color-defined-p 	color-distance
color-gray-p 	color-name-to-rgb
color-supported-p 	color-values
column-number-mode 	combine-after-change-calls
combine-after-change-execute 	combine-and-quote-strings
comint-redirect-results-list
comint-redirect-results-list-from-process
comint-redirect-send-command 	comint-redirect-send-command-to-process
comint-run 	command-apropos
command-error-default-function 	command-execute
command-history 	command-line
command-line-1 	command-line-normalize-file-name
command-remapping 	commandp
comment-add 	comment-beginning
comment-box 	comment-choose-indent
comment-dwim 	comment-enter-backward
comment-forward 	comment-indent
comment-indent-default 	comment-indent-new-line
comment-kill 	comment-make-extra-lines
comment-normalize-vars 	comment-only-p
comment-or-uncomment-region 	comment-padleft
comment-padright 	comment-quote-nested
comment-quote-re 	comment-region
comment-region-default 	comment-region-internal
comment-search-backward 	comment-search-forward
comment-set-column 	comment-string-reverse
comment-string-strip 	comment-valid-prefix-p
comment-with-narrowing 	common-lisp-indent-function
common-lisp-mode 	compare-buffer-substrings
compare-strings 	compare-window-configurations
compare-windows 	compilation-minor-mode
compilation-mode 	compilation-next-error-function
compilation-shell-minor-mode 	compilation-start
compile 	compile-defun
complete-in-turn 	complete-symbol
complete-tag 	complete-with-action
completing-read 	completing-read-default
completing-read-multiple 	completion--cache-all-sorted-completions
completion--capf-wrapper 	completion--common-suffix
completion--complete-and-exit 	completion--cycle-threshold
completion--do-completion 	completion--done
completion--embedded-envvar-table 	completion--field-metadata
completion--file-name-table 	completion--flush-all-sorted-completions
completion--in-region 	completion--in-region-1
completion--insert-strings 	completion--make-envvar-table
completion--merge-suffix 	completion--message
completion--metadata 	completion--nth-completion
completion--replace 	completion--sifn-requote
completion--some 	completion--sreverse
completion--string-equal-p 	completion--styles
completion--try-word-completion 	completion--twq-all
completion--twq-try 	completion-all-completions
completion-all-sorted-completions 	completion-at-point
completion-basic--pattern 	completion-basic-all-completions
completion-basic-try-completion 	completion-boundaries
completion-complete-and-exit 	completion-emacs21-all-completions
completion-emacs21-try-completion 	completion-emacs22-all-completions
completion-emacs22-try-completion 	completion-file-name-table
completion-help-at-point 	completion-hilit-commonality
completion-in-region 	completion-in-region--postch
completion-in-region--single-word 	completion-in-region-mode
completion-initials-all-completions 	completion-initials-expand
completion-initials-try-completion 	completion-list-mode
completion-list-mode-finish 	completion-metadata
completion-metadata-get 	completion-pcm--all-completions
completion-pcm--filename-try-filter 	completion-pcm--find-all-completions
completion-pcm--hilit-commonality 	completion-pcm--merge-completions
completion-pcm--merge-try 	completion-pcm--optimize-pattern
completion-pcm--pattern->regex 	completion-pcm--pattern->string
completion-pcm--pattern-trivial-p 	completion-pcm--prepare-delim-re
completion-pcm--string->pattern 	completion-pcm-all-completions
completion-pcm-try-completion 	completion-setup-function
completion-substring--all-completions 	completion-substring-all-completions
completion-substring-try-completion 	completion-table-case-fold
completion-table-dynamic 	completion-table-in-turn
completion-table-merge 	completion-table-subvert
completion-table-with-cache 	completion-table-with-context
completion-table-with-predicate 	completion-table-with-quoting
completion-table-with-terminator 	completion-try-completion
compose-chars 	compose-chars-after
compose-glyph-string 	compose-glyph-string-relative
compose-gstring-for-graphic 	compose-gstring-for-terminal
compose-gstring-for-variation-glyph 	compose-last-chars
compose-mail 	compose-mail-other-frame
compose-mail-other-window 	compose-region
compose-region-internal 	compose-string
compose-string-internal 	composition-get-gstring
compute-motion 	concat
cond 	condition-case
condition-case-no-debug 	condition-case-unless-debug
conf-colon-mode 	conf-javaprop-mode
conf-mode 	conf-mode-maybe
conf-ppd-mode 	conf-space-keywords
conf-space-mode 	conf-unix-mode
conf-windows-mode 	conf-xdefaults-mode
confirm-nonexistent-file-or-buffer 	cons
consp 	constrain-to-field
constructor 	continue-process
controlling-tty-p 	convert-define-charset-argument
convert-standard-filename 	cookie
cookie-insert 	cookie-snarf
coordinates-in-window-p 	copy-abbrev-table
copy-alist 	copy-case-table
copy-category-table 	copy-dir-locals-to-file-locals
copy-dir-locals-to-file-locals-prop-line
copy-directory 	copy-face
copy-file 	copy-file-locals-to-dir-locals
copy-gtos 	copy-hash-table
copy-keymap 	copy-marker
copy-overlay 	copy-package--bi-desc
copy-package-desc 	copy-rectangle-as-kill
copy-rectangle-to-register 	copy-region-as-kill
copy-sequence 	copy-syntax-table
copy-to-buffer 	copy-to-register
copy-tree 	copyright
copyright-fix-years 	copyright-update
copyright-update-directory 	copysign
cos 	count-lines
count-lines-page 	count-lines-region
count-matches 	count-screen-lines
count-windows 	count-words
count-words--buffer-message 	count-words--message
count-words-region 	cperl-mode
cperl-perldoc 	cperl-perldoc-at-point
cpp-highlight-buffer 	cpp-parse-edit
create-default-fontset 	create-file-buffer
create-fontset-from-ascii-font 	create-fontset-from-fontset-spec
create-fontset-from-x-resource 	create-glyph
create-image 	css-mode
ctext-non-standard-encodings-table 	ctext-post-read-conversion
ctext-pre-write-conversion 	ctl-x-4-prefix
ctl-x-5-prefix 	cua-mode
cua-rectangle-mark-mode 	cua-selection-mode
current-active-maps 	current-bidi-paragraph-direction
current-buffer 	current-case-table
current-column 	current-fill-column
current-frame-configuration 	current-global-map
current-idle-time 	current-indentation
current-input-mode 	current-justification
current-kill 	current-left-margin
current-local-map 	current-message
current-minor-mode-maps 	current-time
current-time-string 	current-time-zone
current-window-configuration 	current-word
custom--frame-color-default 	custom--sort-vars
custom--sort-vars-1 	custom-add-dependencies
custom-add-frequent-value 	custom-add-link
custom-add-load 	custom-add-option
custom-add-package-version 	custom-add-to-group
custom-add-version 	custom-autoload
custom-available-themes 	custom-buffer-create
custom-buffer-create-other-window 	custom-check-theme
custom-current-group 	custom-declare-face
custom-declare-group 	custom-declare-theme
custom-declare-variable 	custom-face-attributes-get
custom-facep 	custom-fix-face-spec
custom-group-of-mode 	custom-handle-all-keywords
custom-handle-keyword 	custom-initialize-changed
custom-initialize-default 	custom-initialize-delay
custom-initialize-reset 	custom-initialize-set
custom-load-symbol 	custom-make-theme-feature
custom-menu-create 	custom-note-var-changed
custom-push-theme 	custom-quote
custom-reevaluate-setting 	custom-reset-faces
custom-reset-variables 	custom-save-all
custom-set-default 	custom-set-faces
custom-set-minor-mode 	custom-set-variables
custom-theme--load-path 	custom-theme-enabled-p
custom-theme-load-confirm 	custom-theme-name-valid-p
custom-theme-p 	custom-theme-recalc-face
custom-theme-recalc-variable 	custom-theme-reset-faces
custom-theme-reset-variables 	custom-theme-set-faces
custom-theme-set-variables 	custom-theme-visit-theme
custom-variable-p 	custom-variable-theme-value
customize 	customize-apropos
customize-apropos-faces 	customize-apropos-groups
customize-apropos-options 	customize-browse
customize-changed 	customize-changed-options
customize-create-theme 	customize-face
customize-face-other-window 	customize-group
customize-group-other-window 	customize-mark-as-set
customize-mark-to-save 	customize-menu-create
customize-mode 	customize-object
customize-option 	customize-option-other-window
customize-push-and-save 	customize-rogue
customize-save-customized 	customize-save-variable
customize-saved 	customize-set-value
customize-set-variable 	customize-themes
customize-unsaved 	customize-variable
customize-variable-other-window 	cvs-checkout
cvs-dired-noselect 	cvs-examine
cvs-global-menu 	cvs-quickdir
cvs-status 	cvs-status-mode
cvs-update 	cwarn-mode
cycle-spacing 	cyrillic-encode-alternativnyj-char
cyrillic-encode-koi8-r-char 	dabbrev-completion
dabbrev-expand 	daemon-initialized
daemonp 	data-debug-new-buffer
date-leap-year-p 	date-to-day
date-to-time 	days-between
days-to-time 	dbus--init-bus
dbus-get-unique-name 	dbus-handle-event
dbus-message-internal 	dbx
dcl-mode 	deactivate-input-method
deactivate-mark 	debian-clean-mailname
debian-expand-file-name-dfsg 	debian-file->string
debian-ispell-add-dictionary-entry 	debian-ispell-build-startup-menu
debian-ispell-get-aspell-default 	debian-ispell-get-hunspell-default
debian-ispell-initialize-dicts-alist 	debian-ispell-preprocess-dicts-alist
debian-ispell-set-default-dictionary 	debian-ispell-set-startup-menu
debian-ispell-try-lang-equiv 	debian-pkg-add-load-path-item
debian-run-directories 	debian-startup
debian-unique-strings 	debug
debug-on-entry 	decipher
decipher-mode 	declare
declare-ccl-program 	declare-equiv-charset
declare-function 	decode-big5-char
decode-char 	decode-coding-inserted-region
decode-coding-region 	decode-coding-string
decode-composition-components 	decode-composition-rule
decode-hz-buffer 	decode-hz-region
decode-sjis-char 	decode-time
decompose-region 	decompose-string
decrease-left-margin 	decrease-right-margin
def-edebug-spec 	defadvice
defalias 	default-boundp
default-file-modes 	default-font-height
default-indent-new-line 	default-line-height
default-toplevel-value 	default-value
defclass 	defconst
defcustom 	defface
defgeneric 	defgroup
defimage 	define-abbrev
define-abbrev-table 	define-abbrevs
define-alternatives 	define-auto-insert
define-button-type 	define-category
define-ccl-program 	define-char-code-property
define-charset 	define-charset-alias
define-charset-internal 	define-coding-system
define-coding-system-alias 	define-coding-system-internal
define-derived-mode 	define-error
define-fringe-bitmap 	define-generic-mode
define-global-abbrev 	define-global-minor-mode
define-globalized-minor-mode 	define-hash-table-test
define-ibuffer-column 	define-ibuffer-filter
define-ibuffer-op 	define-ibuffer-sorter
define-key 	define-key-after
define-mail-abbrev 	define-mail-alias
define-mail-user-agent 	define-minor-mode
define-mode-abbrev 	define-obsolete-face-alias
define-obsolete-function-alias 	define-obsolete-variable-alias
define-package 	define-prefix-command
define-skeleton 	define-translation-hash-table
define-translation-table 	define-widget
define-widget-keywords 	defined-colors
defining-kbd-macro 	defmacro
defmath 	defmethod
defsubst 	deftheme
defun 	defvar
defvar-local 	defvaralias
degrees-to-radians 	delay-mode-hooks
delay-warning 	delete
delete-all-overlays 	delete-and-extract-region
delete-auto-save-file-if-necessary 	delete-backward-char
delete-blank-lines 	delete-char
delete-completion-window 	delete-consecutive-dups
delete-dir-local-variable 	delete-directory
delete-directory-internal 	delete-duplicate-lines
delete-dups 	delete-extract-rectangle
delete-field 	delete-file
delete-file-local-variable 	delete-file-local-variable-prop-line
delete-forward-char 	delete-frame
delete-frame-enabled-p 	delete-horizontal-space
delete-indentation 	delete-matching-lines
delete-minibuffer-contents 	delete-non-matching-lines
delete-other-frames 	delete-other-windows
delete-other-windows-internal 	delete-other-windows-vertically
delete-overlay 	delete-pair
delete-process 	delete-rectangle
delete-region 	delete-selection-mode
delete-side-window 	delete-terminal
delete-to-left-margin 	delete-trailing-whitespace
delete-whitespace-rectangle 	delete-window
delete-window-internal 	delete-windows-on
delimit-columns-customize 	delimit-columns-rectangle
delimit-columns-region 	delphi-mode
delq 	denato-region
derived-mode-init-mode-variables 	derived-mode-p
describe-bindings 	describe-bindings-internal
describe-buffer-bindings 	describe-buffer-case-table
describe-categories 	describe-char
describe-character-set 	describe-chinese-environment-map
describe-coding-system 	describe-copying
describe-current-coding-system 	describe-current-coding-system-briefly
describe-current-display-table 	describe-current-input-method
describe-cyrillic-environment-map 	describe-display-table
describe-distribution 	describe-european-environment-map
describe-face 	describe-font
describe-fontset 	describe-function
describe-function-1 	describe-gnu-project
describe-indian-environment-map 	describe-input-method
describe-key 	describe-key-briefly
describe-language-environment 	describe-minor-mode
describe-minor-mode-completion-table-for-indicator
describe-minor-mode-completion-table-for-symbol
describe-minor-mode-from-indicator 	describe-minor-mode-from-symbol
describe-mode 	describe-no-warranty
describe-package 	describe-package-1
describe-prefix-bindings 	describe-project
describe-register-1 	describe-specified-language-support
describe-syntax 	describe-text-properties
describe-theme 	describe-variable
describe-variable-custom-version-info 	describe-vector
desktop-change-dir 	desktop-clear
desktop-load-default 	desktop-read
desktop-remove 	desktop-revert
desktop-save 	desktop-save-in-desktop-dir
desktop-save-mode 	destroy-fringe-bitmap
destructor 	detect-coding-region
detect-coding-string 	detect-coding-with-language-environment
detect-coding-with-priority 	diary
diary-mail-entries 	diary-mode
diff 	diff-backup
diff-buffer-with-file 	diff-latest-backup-file
diff-minor-mode 	diff-mode
dig 	digit-argument
ding 	dir-locals-collect-mode-variables
dir-locals-collect-variables 	dir-locals-find-file
dir-locals-get-class-variables 	dir-locals-read-from-file
dir-locals-set-class-variables 	dir-locals-set-directory-class
directory-file-name 	directory-files
directory-files-and-attributes 	dired
dired-add-file 	dired-advertise
dired-advertised-find-file 	dired-align-file
dired-alist-add-1 	dired-at-point
dired-backup-diff 	dired-between-files
dired-buffer-stale-p 	dired-buffers-for-dir
dired-build-subdir-alist 	dired-change-marks
dired-check-switches 	dired-clean-directory
dired-clean-up-after-deletion 	dired-clear-alist
dired-compare-directories 	dired-compress-file
dired-copy-file 	dired-copy-filename-as-kill
dired-create-directory 	dired-current-directory
dired-delete-entry 	dired-delete-file
dired-desktop-buffer-misc-data 	dired-diff
dired-directory-changed-p 	dired-display-file
dired-dnd-do-ask-action 	dired-dnd-handle-file
dired-dnd-handle-local-file 	dired-dnd-popup-notice
dired-do-async-shell-command 	dired-do-byte-compile
dired-do-chgrp 	dired-do-chmod
dired-do-chown 	dired-do-compress
dired-do-copy 	dired-do-copy-regexp
dired-do-delete 	dired-do-flagged-delete
dired-do-hardlink 	dired-do-hardlink-regexp
dired-do-isearch 	dired-do-isearch-regexp
dired-do-kill-lines 	dired-do-load
dired-do-print 	dired-do-query-replace-regexp
dired-do-redisplay 	dired-do-relsymlink
dired-do-rename 	dired-do-rename-regexp
dired-do-search 	dired-do-shell-command
dired-do-symlink 	dired-do-symlink-regexp
dired-do-touch 	dired-downcase
dired-file-marker 	dired-file-name-at-point
dired-find-alternate-file 	dired-find-buffer-nocreate
dired-find-file 	dired-find-file-other-window
dired-flag-auto-save-files 	dired-flag-backup-files
dired-flag-file-deletion 	dired-flag-files-regexp
dired-flag-garbage-files 	dired-format-columns-of-files
dired-fun-in-all-buffers 	dired-get-file-for-visit
dired-get-filename 	dired-get-marked-files
dired-get-subdir 	dired-get-subdir-max
dired-get-subdir-min 	dired-glob-regexp
dired-goto-file 	dired-goto-file-1
dired-goto-next-file 	dired-goto-next-nontrivial-file
dired-goto-subdir 	dired-hide-all
dired-hide-details-mode
dired-hide-details-update-invisibility-spec
dired-hide-subdir 	dired-in-this-tree
dired-initial-position 	dired-insert-directory
dired-insert-old-subdirs 	dired-insert-set-properties
dired-insert-subdir 	dired-internal-do-deletions
dired-internal-noselect 	dired-isearch-filenames
dired-isearch-filenames-regexp 	dired-isearch-filenames-setup
dired-jump 	dired-jump-other-window
dired-kill-subdir 	dired-log
dired-log-summary 	dired-make-absolute
dired-make-relative 	dired-map-over-marks
dired-mark 	dired-mark-directories
dired-mark-executables 	dired-mark-files-containing-regexp
dired-mark-files-in-region 	dired-mark-files-regexp
dired-mark-if 	dired-mark-pop-up
dired-mark-prompt 	dired-mark-remembered
dired-mark-subdir-files 	dired-mark-symlinks
dired-marker-regexp 	dired-maybe-insert-subdir
dired-mode 	dired-mouse-find-file-other-window
dired-move-to-end-of-filename 	dired-move-to-filename
dired-next-dirline 	dired-next-line
dired-next-marked-file 	dired-next-subdir
dired-normalize-subdir 	dired-noselect
dired-other-frame 	dired-other-window
dired-plural-s 	dired-pop-to-buffer
dired-prev-dirline 	dired-prev-marked-file
dired-prev-subdir 	dired-previous-line
dired-query 	dired-read-dir-and-switches
dired-read-regexp 	dired-readin
dired-readin-insert 	dired-relist-file
dired-remember-hidden 	dired-remember-marks
dired-remove-file 	dired-rename-file
dired-repeat-over-lines 	dired-replace-in-string
dired-restore-desktop-buffer 	dired-restore-positions
dired-revert 	dired-run-shell-command
dired-safe-switches-p 	dired-save-positions
dired-show-file-type 	dired-sort-R-check
dired-sort-other 	dired-sort-set-mode-line
dired-sort-set-modeline 	dired-sort-toggle
dired-sort-toggle-or-edit 	dired-string-replace-match
dired-subdir-index 	dired-subdir-max
dired-summary 	dired-switches-escape-p
dired-switches-recursive-p 	dired-toggle-marks
dired-toggle-read-only 	dired-tree-down
dired-tree-up 	dired-unadvertise
dired-uncache 	dired-undo
dired-unmark 	dired-unmark-all-files
dired-unmark-all-marks 	dired-unmark-backward
dired-up-directory 	dired-upcase
dired-view-file 	dired-why
dirtrack 	dirtrack-mode
disable-command 	disable-theme
disable-timeout 	disabled-command-function
disassemble 	disassemble-offset
discard-input 	display-about-screen
display-backing-store 	display-battery-mode
display-buffer
display-buffer--maybe-pop-up-frame-or-window
display-buffer--maybe-same-window 	display-buffer--special-action
display-buffer-assq-regexp 	display-buffer-at-bottom
display-buffer-below-selected 	display-buffer-in-atom-window
display-buffer-in-major-side-window 	display-buffer-in-previous-window
display-buffer-in-side-window 	display-buffer-no-window
display-buffer-other-frame 	display-buffer-pop-up-frame
display-buffer-pop-up-window 	display-buffer-record-window
display-buffer-reuse-window 	display-buffer-same-window
display-buffer-use-some-window 	display-call-tree
display-color-cells 	display-color-p
display-completion-list 	display-delayed-warnings
display-graphic-p 	display-grayscale-p
display-images-p 	display-local-help
display-message-or-buffer 	display-mm-height
display-mm-width 	display-monitor-attributes-list
display-mouse-p 	display-multi-font-p
display-multi-frame-p 	display-pixel-height
display-pixel-width 	display-planes
display-popup-menus-p 	display-save-under
display-screens 	display-selections-p
display-splash-screen 	display-startup-echo-area-message
display-startup-screen 	display-supports-face-attributes-p
display-table-slot 	display-time
display-time-mode 	display-time-world
display-visual-class 	display-warning
displaying-byte-compile-warnings 	dissociated-press
dnd-get-local-file-name 	dnd-get-local-file-uri
dnd-handle-one-url 	dnd-insert-text
dnd-open-file 	dnd-open-local-file
dnd-open-remote-url 	dnd-unescape-uri
dns-lookup-host 	dns-mode
dns-mode-soa-increment-serial 	dnsDomainIs
dnsResolve 	do-after-load-evaluation
do-auto-fill 	do-auto-save
doc-file-to-info 	doc-file-to-man
doc-view-bookmark-jump 	doc-view-minor-mode
doc-view-mode 	doc-view-mode-maybe
doc-view-mode-p 	doctex-mode
doctor 	documentation
documentation-property 	dolist
dont-compile 	dotimes
dotimes-with-progress-reporter 	double-mode
down-list 	downcase
downcase-region 	downcase-word
dsssl-mode 	dump-emacs
dunnet 	dynamic-completion-mode
dynamic-completion-table
dynamic-setting-handle-config-changed-event
easy-menu-add 	easy-menu-add-item
easy-menu-always-true-p 	easy-menu-binding
easy-menu-change 	easy-menu-convert-item
easy-menu-convert-item-1 	easy-menu-create-menu
easy-menu-define 	easy-menu-define-key
easy-menu-do-define 	easy-menu-filter-return
easy-menu-get-map 	easy-menu-intern
easy-menu-item-present-p 	easy-menu-lookup-name
easy-menu-make-symbol 	easy-menu-name-match
easy-menu-remove 	easy-menu-remove-item
easy-menu-return-item 	easy-mmode-define-global-mode
easy-mmode-define-keymap 	easy-mmode-define-minor-mode
easy-mmode-defmap 	easy-mmode-defsyntax
ebnf-apply-style 	ebnf-customize
ebnf-delete-style 	ebnf-despool
ebnf-eps-buffer 	ebnf-eps-directory
ebnf-eps-file 	ebnf-eps-region
ebnf-find-style 	ebnf-insert-style
ebnf-merge-style 	ebnf-pop-style
ebnf-print-buffer 	ebnf-print-directory
ebnf-print-file 	ebnf-print-region
ebnf-push-style 	ebnf-reset-style
ebnf-setup 	ebnf-spool-buffer
ebnf-spool-directory 	ebnf-spool-file
ebnf-spool-region 	ebnf-syntax-buffer
ebnf-syntax-directory 	ebnf-syntax-file
ebnf-syntax-region 	ebrowse-back-in-position-stack
ebrowse-electric-choose-tree 	ebrowse-electric-position-menu
ebrowse-forward-in-position-stack 	ebrowse-member-mode
ebrowse-save-tree 	ebrowse-save-tree-as
ebrowse-statistics 	ebrowse-tags-complete-symbol
ebrowse-tags-find-declaration
ebrowse-tags-find-declaration-other-frame
ebrowse-tags-find-declaration-other-window
ebrowse-tags-find-definition 	ebrowse-tags-find-definition-other-frame
ebrowse-tags-find-definition-other-window
ebrowse-tags-loop-continue 	ebrowse-tags-query-replace
ebrowse-tags-search 	ebrowse-tags-search-member-use
ebrowse-tags-view-declaration 	ebrowse-tags-view-definition
ebrowse-tags-view-definition-other-frame
ebrowse-tags-view-definition-other-window
ebrowse-tree-mode 	ebuffers
ebuffers3 	ecomplete-setup
edebug-all-defs 	edebug-all-forms
edebug-basic-spec 	edebug-defun
edebug-eval-top-level-form 	ediff
ediff-backup 	ediff-buffers
ediff-buffers3 	ediff-current-file
ediff-customize 	ediff-directories
ediff-directories-command 	ediff-directories3
ediff-directories3-command 	ediff-directory-revisions
ediff-documentation 	ediff-files
ediff-files-command 	ediff-files3
ediff-merge 	ediff-merge-buffers
ediff-merge-buffers-with-ancestor 	ediff-merge-command
ediff-merge-directories 	ediff-merge-directories-command
ediff-merge-directories-with-ancestor
ediff-merge-directories-with-ancestor-command
ediff-merge-directory-revisions
ediff-merge-directory-revisions-with-ancestor
ediff-merge-files 	ediff-merge-files-with-ancestor
ediff-merge-revisions 	ediff-merge-revisions-with-ancestor
ediff-merge-with-ancestor 	ediff-merge-with-ancestor-command
ediff-patch-buffer 	ediff-patch-file
ediff-regions-linewise 	ediff-regions-wordwise
ediff-revision 	ediff-show-registry
ediff-toggle-multiframe 	ediff-toggle-use-toolbar
ediff-version 	ediff-windows-linewise
ediff-windows-wordwise 	ediff3
ediff3-files-command 	edir-merge-revisions
edir-merge-revisions-with-ancestor 	edir-revisions
edirs 	edirs-merge
edirs-merge-with-ancestor 	edirs3
edit-abbrevs 	edit-abbrevs-mode
edit-abbrevs-redefine 	edit-and-eval-command
edit-bookmarks 	edit-kbd-macro
edit-last-kbd-macro 	edit-named-kbd-macro
edit-picture 	edit-tab-stops
edit-tab-stops-note-changes 	edt-emulation-on
edt-set-scroll-margins 	eieio--check-type
eieio--class--unused-0 	eieio--class-children
eieio--class-class-allocation-a 	eieio--class-class-allocation-custom
eieio--class-class-allocation-custom-group
eieio--class-class-allocation-custom-label
eieio--class-class-allocation-doc 	eieio--class-class-allocation-printer
eieio--class-class-allocation-protection
eieio--class-class-allocation-type 	eieio--class-class-allocation-values
eieio--class-default-object-cache 	eieio--class-initarg-tuples
eieio--class-options 	eieio--class-parent
eieio--class-protection 	eieio--class-public-a
eieio--class-public-custom 	eieio--class-public-custom-group
eieio--class-public-custom-label 	eieio--class-public-d
eieio--class-public-doc 	eieio--class-public-printer
eieio--class-public-type 	eieio--class-symbol
eieio--class-symbol-obarray 	eieio--defalias
eieio--defgeneric-init-form 	eieio--define-field-accessors
eieio--defmethod 	eieio--object--unused-0
eieio--object-class 	eieio--object-name
eieio--scoped-class 	eieio--typep
eieio--with-scoped-class 	eieio-add-new-slot
eieio-attribute-to-initarg 	eieio-barf-if-slot-unbound
eieio-browse 	eieio-c3-candidate
eieio-c3-merge-lists 	eieio-class-children
eieio-class-children-fast 	eieio-class-name
eieio-class-parent 	eieio-class-parents
eieio-class-parents-fast 	eieio-class-precedence-bfs
eieio-class-precedence-c3 	eieio-class-precedence-dfs
eieio-class-precedence-list 	eieio-class-slot-name-index
eieio-class-un-autoload 	eieio-compiled-function-arglist
eieio-copy-parents-into-subclass 	eieio-default-eval-maybe
eieio-default-superclass 	eieio-default-superclass-child-p
eieio-default-superclass-list-p 	eieio-default-superclass-p
eieio-defclass 	eieio-defclass-autoload
eieio-defgeneric 	eieio-defgeneric-form
eieio-defgeneric-form-primary-only 	eieio-defgeneric-form-primary-only-one
eieio-defgeneric-reset-generic-form
eieio-defgeneric-reset-generic-form-primary-only
eieio-defgeneric-reset-generic-form-primary-only-one
eieio-defmethod 	eieio-edebug-prin1-to-string
eieio-eval-default-p 	eieio-generic-call
eieio-generic-call-primary-only 	eieio-generic-form
eieio-help-class 	eieio-help-constructor
eieio-help-generic 	eieio-initarg-to-attribute
eieio-list-prin1 	eieio-object-class
eieio-object-class-name 	eieio-object-name
eieio-object-name-string 	eieio-object-p
eieio-object-set-name-string 	eieio-oref
eieio-oref-default 	eieio-oset
eieio-oset-default 	eieio-override-prin1
eieio-perform-slot-validation
eieio-perform-slot-validation-for-default
eieio-set-defaults 	eieio-slot-name-index
eieio-slot-originating-class-p 	eieio-specialized-key-to-generic-key
eieio-unbind-method-implementations 	eieio-validate-class-slot-value
eieio-validate-slot-value 	eieio-version
eieiomt-add 	eieiomt-install
eieiomt-method-list 	eieiomt-next
eieiomt-sym-optimize 	eldoc-mode
electric--after-char-pos 	electric--sort-post-self-insertion-hook
electric-buffer-list 	electric-helpify
electric-indent-just-newline 	electric-indent-local-mode
electric-indent-mode
electric-indent-post-self-insert-function
electric-layout-mode
electric-layout-post-self-insert-function
electric-newline-and-maybe-indent 	electric-pair-mode
elide-head 	elint-current-buffer
elint-defun 	elint-directory
elint-file 	elint-initialize
elisp-format-buffer 	elisp-format-directory
elisp-format-directory-batch 	elisp-format-dired-mark-files
elisp-format-file 	elisp-format-file-batch
elisp-format-library 	elisp-format-region
elisp-index-search 	elp-instrument-function
elp-instrument-list 	elp-instrument-package
elp-results 	elt
emacs-bzr-get-version 	emacs-bzr-version-bzr
emacs-bzr-version-dirstate 	emacs-index-search
emacs-init-time 	emacs-lisp-byte-code-comment
emacs-lisp-byte-code-mode 	emacs-lisp-byte-code-syntax-propertize
emacs-lisp-byte-compile 	emacs-lisp-byte-compile-and-load
emacs-lisp-mode 	emacs-lock-mode
emacs-pid 	emacs-repository-get-version
emacs-session-filename 	emacs-session-restore
emacs-session-save 	emacs-uptime
emacs-version 	emerge-buffers
emerge-buffers-with-ancestor 	emerge-files
emerge-files-command 	emerge-files-remote
emerge-files-with-ancestor 	emerge-files-with-ancestor-command
emerge-files-with-ancestor-remote 	emerge-merge-directories
emerge-revisions 	emerge-revisions-with-ancestor
enable-command 	enable-flow-control
enable-flow-control-on 	enable-theme
encode-big5-char 	encode-char
encode-coding-char 	encode-coding-region
encode-coding-string 	encode-composition-components
encode-composition-rule 	encode-hz-buffer
encode-hz-region 	encode-sjis-char
encode-time 	encode-time-value
encoded-string-description 	end-kbd-macro
end-of-buffer 	end-of-buffer-other-window
end-of-defun 	end-of-line
end-of-paragraph-text 	end-of-visible-line
end-of-visual-line 	enlarge-window
enlarge-window-horizontally 	enriched-decode
enriched-encode 	enriched-mode
eobp 	eolp
epa-decrypt-armor-in-region 	epa-decrypt-file
epa-decrypt-region 	epa-delete-keys
epa-dired-do-decrypt 	epa-dired-do-encrypt
epa-dired-do-sign 	epa-dired-do-verify
epa-encrypt-file 	epa-encrypt-region
epa-export-keys 	epa-file--file-name-regexp-set
epa-file-disable 	epa-file-enable
epa-file-find-file-hook 	epa-file-handler
epa-file-name-regexp-update 	epa-global-mail-mode
epa-import-armor-in-region 	epa-import-keys
epa-import-keys-region 	epa-insert-keys
epa-list-keys 	epa-list-secret-keys
epa-mail-decrypt 	epa-mail-encrypt
epa-mail-import-keys 	epa-mail-mode
epa-mail-sign 	epa-mail-verify
epa-select-keys 	epa-sign-file
epa-sign-region 	epa-verify-cleartext-in-region
epa-verify-file 	epa-verify-region
epatch 	epatch-buffer
epg-check-configuration 	epg-config--compare-version
epg-config--parse-version 	epg-configuration
epg-context-set-armor 	epg-context-set-passphrase-callback
epg-decrypt-string 	epg-encrypt-string
epg-expand-group 	epg-make-context
eq 	eql
equal 	equal-including-properties
erase-buffer 	erc
erc-add-dangerous-host 	erc-add-fool
erc-add-keyword 	erc-add-pal
erc-autoaway-mode 	erc-autojoin-mode
erc-button-mode 	erc-capab-identify-mode
erc-cmd-DCC 	erc-cmd-NOTIFY
erc-cmd-WHOLEFT 	erc-cmd-ezb
erc-completion-mode 	erc-create-imenu-index
erc-ctcp-query-DCC 	erc-dcc-mode
erc-define-minor-mode 	erc-delete-dangerous-host
erc-delete-fool 	erc-delete-keyword
erc-delete-pal 	erc-determine-network
erc-ezb-add-session 	erc-ezb-end-of-session-list
erc-ezb-get-login 	erc-ezb-identify
erc-ezb-init-session-list 	erc-ezb-initialize
erc-ezb-lookup-action 	erc-ezb-notice-autodetect
erc-ezb-select 	erc-ezb-select-session
erc-fill 	erc-fill-mode
erc-handle-irc-url 	erc-identd-mode
erc-identd-start 	erc-identd-stop
erc-list-mode 	erc-log-mode
erc-logging-enabled 	erc-match-mode
erc-menu-mode 	erc-netsplit-mode
erc-nickserv-identify 	erc-nickserv-identify-mode
erc-notifications-mode 	erc-notify-mode
erc-page-mode 	erc-replace-mode
erc-ring-mode 	erc-save-buffer-in-logs
erc-select 	erc-select-read-args
erc-server-select 	erc-services-mode
erc-sound-mode 	erc-speedbar-browser
erc-spelling-mode 	erc-timestamp-mode
erc-tls 	erc-track-minor-mode
erc-track-mode 	erc-truncate-buffer
erc-truncate-buffer-to-size 	erc-truncate-mode
erc-xdcc-add-file 	erc-xdcc-mode
eregistry 	erevision
error 	error-message-string
ert 	ert-deftest
ert-describe-test 	ert-kill-all-test-buffers
ert-run-tests-batch 	ert-run-tests-batch-and-exit
ert-run-tests-interactively 	eshell
eshell-command 	eshell-command-result
eshell-mode 	eshell-report-bug
ethio-composition-function 	ethio-fidel-to-java-buffer
ethio-fidel-to-sera-buffer 	ethio-fidel-to-sera-marker
ethio-fidel-to-sera-region 	ethio-fidel-to-tex-buffer
ethio-find-file 	ethio-input-special-character
ethio-insert-ethio-space 	ethio-java-to-fidel-buffer
ethio-modify-vowel 	ethio-replace-space
ethio-sera-to-fidel-buffer 	ethio-sera-to-fidel-marker
ethio-sera-to-fidel-region 	ethio-tex-to-fidel-buffer
ethio-write-file 	eudc-display-generic-binary
eudc-display-jpeg-as-button 	eudc-display-jpeg-inline
eudc-display-mail 	eudc-display-sound
eudc-display-url 	eudc-edit-hotlist
eudc-expand-inline 	eudc-get-email
eudc-get-phone 	eudc-insert-record-at-point-into-bbdb
eudc-load-eudc 	eudc-query-form
eudc-set-server 	eudc-tools-menu
eudc-try-bbdb-insert 	eval
eval-after-load 	eval-and-compile
eval-buffer 	eval-current-buffer
eval-defun 	eval-defun-1
eval-defun-2 	eval-expression
eval-expression-print-format 	eval-last-sexp
eval-last-sexp-1 	eval-last-sexp-print-value
eval-minibuffer 	eval-next-after-load
eval-print-last-sexp 	eval-region
eval-sexp-add-defvars 	eval-when-compile
event-apply-alt-modifier 	event-apply-control-modifier
event-apply-hyper-modifier 	event-apply-meta-modifier
event-apply-modifier 	event-apply-shift-modifier
event-apply-super-modifier 	event-basic-type
event-click-count 	event-convert-list
event-end 	event-modifiers
event-start 	eventp
ewoc-create 	eww
eww-browse-url 	eww-open-file
exchange-dot-and-mark 	exchange-point-and-mark
executable-command-find-posix-p 	executable-find
executable-interpret
executable-make-buffer-file-executable-if-script-p
executable-self-display 	executable-set-magic
execute-extended-command 	execute-kbd-macro
exit-minibuffer 	exit-recursive-edit
exit-splash-screen 	exp
expand-abbrev 	expand-abbrev-hook
expand-add-abbrevs 	expand-file-name
expand-jump-to-next-slot 	expand-jump-to-previous-slot
expand-mail-aliases 	expand-region-abbrevs
expt 	external-debugging-output
extract-rectangle 	f90-mode
face-all-attributes 	face-at-point
face-attr-construct 	face-attr-match-p
face-attribute 	face-attribute-merged-with
face-attribute-relative-p 	face-attribute-specified-or
face-attributes-as-vector 	face-background
face-background-pixmap 	face-bold-p
face-default-spec 	face-descriptive-attribute-name
face-differs-from-default-p 	face-doc-string
face-documentation 	face-equal
face-font 	face-foreground
face-id 	face-inverse-video-p
face-italic-p 	face-list
face-name 	face-nontrivial-p
face-read-integer 	face-read-string
face-remap-add-relative 	face-remap-reset-base
face-remap-set-base 	face-set-after-frame-default
face-spec-choose 	face-spec-match-p
face-spec-recalc 	face-spec-reset-face
face-spec-set 	face-spec-set-2
face-spec-set-match-display 	face-stipple
face-underline-p 	face-user-default-spec
face-valid-attribute-values 	facemenu-active-faces
facemenu-add-face 	facemenu-add-new-color
facemenu-add-new-face 	facemenu-background-menu
facemenu-color-equal 	facemenu-complete-face-list
facemenu-enable-faces-p 	facemenu-face-menu
facemenu-foreground-menu 	facemenu-indentation-menu
facemenu-iterate 	facemenu-justification-menu
facemenu-keymap 	facemenu-menu
facemenu-post-self-insert-function 	facemenu-read-color
facemenu-remove-all 	facemenu-remove-face-props
facemenu-remove-special 	facemenu-set-background
facemenu-set-bold 	facemenu-set-bold-italic
facemenu-set-default 	facemenu-set-face
facemenu-set-face-from-menu 	facemenu-set-foreground
facemenu-set-intangible 	facemenu-set-invisible
facemenu-set-italic 	facemenu-set-read-only
facemenu-set-self-insert-face 	facemenu-set-underline
facemenu-special-menu 	facemenu-update
facep 	fancy-about-screen
fancy-splash-frame 	fancy-splash-head
fancy-splash-image-file 	fancy-splash-insert
fancy-startup-screen 	fancy-startup-tail
fboundp 	fceiling
featurep 	feedmail-queue-reminder
feedmail-run-the-queue 	feedmail-run-the-queue-global-prompt
feedmail-run-the-queue-no-prompts 	feedmail-send-it
fetch-bytecode 	ff-find-other-file
ff-find-related-file 	ff-get-other-file
ff-mouse-find-other-file 	ff-mouse-find-other-file-other-window
ffap 	ffap-at-mouse
ffap-bindings 	ffap-guess-file-name-at-point
ffap-menu 	ffap-next
ffloor 	field-at-pos
field-beginning 	field-complete
field-end 	field-string
field-string-no-properties 	file-accessible-directory-p
file-acl 	file-attributes
file-attributes-lessp 	file-cache-add-directory
file-cache-add-directory-list 	file-cache-add-directory-recursively
file-cache-add-directory-using-find 	file-cache-add-directory-using-locate
file-cache-add-file 	file-cache-minibuffer-complete
file-chase-links 	file-directory-p
file-equal-p 	file-executable-p
file-exists-p 	file-expand-wildcards
file-extended-attributes 	file-in-directory-p
file-local-copy 	file-locked-p
file-modes 	file-modes-char-to-right
file-modes-char-to-who 	file-modes-rights-to-number
file-modes-symbolic-to-number 	file-name-absolute-p
file-name-all-completions 	file-name-as-directory
file-name-base 	file-name-completion
file-name-directory 	file-name-extension
file-name-non-special 	file-name-nondirectory
file-name-sans-extension 	file-name-sans-versions
file-name-shadow-mode 	file-newer-than-file-p
file-newest-backup 	file-nlinks
file-notify-handle-event 	file-ownership-preserved-p
file-readable-p 	file-regular-p
file-relative-name 	file-remote-p
file-selinux-context 	file-size-human-readable
file-symlink-p 	file-truename
file-writable-p 	filesets-init
fill-comment-paragraph 	fill-common-string-prefix
fill-context-prefix 	fill-delete-newlines
fill-delete-prefix 	fill-find-break-point
fill-flowed 	fill-flowed-encode
fill-forward-paragraph 	fill-french-nobreak-p
fill-indent-to-left-margin 	fill-individual-paragraphs
fill-individual-paragraphs-citation 	fill-individual-paragraphs-prefix
fill-match-adaptive-prefix 	fill-minibuffer-function
fill-move-to-break-point 	fill-newline
fill-nobreak-p 	fill-nonuniform-paragraphs
fill-paragraph 	fill-region
fill-region-as-paragraph 	fill-single-char-nobreak-p
fill-single-word-nobreak-p 	fill-text-properties-at
fillarray 	filter-buffer-substring
filtered-frame-list 	find-alternate-file
find-alternate-file-other-window 	find-auto-coding
find-backup-file-name 	find-buffer-visiting
find-change-log 	find-charset-region
find-charset-string 	find-class
find-cmd 	find-coding-systems-for-charsets
find-coding-systems-region 	find-coding-systems-region-internal
find-coding-systems-string 	find-composition
find-composition-internal 	find-definition-noselect
find-dired 	find-face-definition
find-file 	find-file--read-only
find-file-at-point 	find-file-existing
find-file-literally 	find-file-name-handler
find-file-noselect 	find-file-noselect-1
find-file-other-frame 	find-file-other-window
find-file-read-args 	find-file-read-only
find-file-read-only-other-frame 	find-file-read-only-other-window
find-font 	find-function
find-function-at-point 	find-function-noselect
find-function-on-key 	find-function-other-frame
find-function-other-window 	find-function-search-for-symbol
find-function-setup-keys 	find-grep
find-grep-dired 	find-image
find-library 	find-lisp-find-dired
find-lisp-find-dired-filter 	find-lisp-find-dired-subdirectories
find-lisp-object-file-name 	find-multibyte-characters
find-name-dired 	find-new-buffer-file-coding-system
find-operation-coding-system 	find-tag
find-tag-default 	find-tag-default-as-regexp
find-tag-default-as-symbol-regexp 	find-tag-default-bounds
find-tag-noselect 	find-tag-other-frame
find-tag-other-window 	find-tag-regexp
find-variable 	find-variable-at-point
find-variable-noselect 	find-variable-other-frame
find-variable-other-window 	finder-by-keyword
finder-commentary 	finder-list-keywords
finger 	first-error
fit-frame-to-buffer 	fit-window-to-buffer
fixup-whitespace 	float
float-time 	floatp
floor 	flush-lines
flymake-find-file-hook 	flymake-mode
flymake-mode-off 	flymake-mode-on
flyspell-buffer 	flyspell-mode
flyspell-mode-off 	flyspell-prog-mode
flyspell-region 	flyspell-word
fmakunbound 	focus-frame
follow-delete-other-windows-and-split 	follow-mode
following-char 	font-at
font-face-attributes 	font-family-list
font-get 	font-get-glyphs
font-get-system-font 	font-get-system-normal-font
font-info 	font-lock-add-keywords
font-lock-after-change-function 	font-lock-after-fontify-buffer
font-lock-after-unfontify-buffer 	font-lock-append-text-property
font-lock-apply-highlight 	font-lock-apply-syntactic-highlight
font-lock-change-mode 	font-lock-choose-keywords
font-lock-compile-keyword 	font-lock-compile-keywords
font-lock-default-fontify-buffer 	font-lock-default-fontify-region
font-lock-default-function 	font-lock-default-unfontify-buffer
font-lock-default-unfontify-region 	font-lock-defontify
font-lock-eval-keywords
font-lock-extend-jit-lock-region-after-change
font-lock-extend-region-multiline 	font-lock-extend-region-wholelines
font-lock-fillin-text-property 	font-lock-fontify-anchored-keywords
font-lock-fontify-block 	font-lock-fontify-buffer
font-lock-fontify-keywords-region 	font-lock-fontify-region
font-lock-fontify-syntactic-anchored-keywords
font-lock-fontify-syntactic-keywords-region
font-lock-fontify-syntactically-region 	font-lock-initial-fontify
font-lock-match-c-style-declaration-item-and-skip-to-next
font-lock-mode 	font-lock-mode-internal
font-lock-mode-set-explicitly 	font-lock-prepend-text-property
font-lock-refresh-defaults 	font-lock-remove-keywords
font-lock-set-defaults 	font-lock-specified-p
font-lock-turn-off-thing-lock 	font-lock-turn-on-thing-lock
font-lock-unfontify-buffer 	font-lock-unfontify-region
font-lock-update-removed-keyword-alist 	font-lock-value-in-major-mode
font-match-p 	font-menu-add-default
font-put 	font-setting-change-default-font
font-shape-gstring 	font-show-log
font-spec 	font-variation-glyphs
font-xlfd-name 	fontp
fontset-font 	fontset-info
fontset-list 	fontset-name-p
fontset-plain-name 	footnote-mode
force-mode-line-update 	force-window-update
foreground-color-at-point 	format
format-annotate-atomic-property-change 	format-annotate-function
format-annotate-location 	format-annotate-region
format-annotate-single-property-change 	format-annotate-value
format-deannotate-region 	format-decode
format-decode-buffer 	format-decode-region
format-decode-run-method 	format-delq-cons
format-encode-buffer 	format-encode-region
format-encode-run-method 	format-find-file
format-insert-annotations 	format-insert-file
format-kbd-macro 	format-make-relatively-unique
format-mode-line 	format-network-address
format-proper-list-p 	format-property-increment-region
format-read 	format-reorder
format-replace-strings 	format-seconds
format-subtract-regions 	format-time-string
format-write-file 	forms-find-file
forms-find-file-other-window 	forms-mode
fortran-mode 	fortune
fortune-add-fortune 	fortune-compile
fortune-from-region 	fortune-to-signature
forward-button 	forward-char
forward-comment 	forward-line
forward-list 	forward-page
forward-paragraph 	forward-point
forward-same-syntax 	forward-sentence
forward-sexp 	forward-symbol
forward-thing 	forward-to-indentation
forward-visible-line 	forward-whitespace
forward-word 	frame-border-width
frame-bottom-divider-width 	frame-char-height
frame-char-size 	frame-char-width
frame-configuration-p 	frame-configuration-to-register
frame-current-scroll-bars 	frame-face-alist
frame-first-window 	frame-focus
frame-font-cache 	frame-fringe-width
frame-geom-spec-cons 	frame-geom-value-cons
frame-height 	frame-initialize
frame-list 	frame-live-p
frame-monitor-attributes 	frame-notice-user-settings
frame-or-buffer-changed-p 	frame-parameter
frame-parameters 	frame-pixel-height
frame-pixel-width 	frame-pointer-visible-p
frame-remove-geometry-params 	frame-right-divider-width
frame-root-window 	frame-root-window-p
frame-scroll-bar-width 	frame-selected-window
frame-set-background-mode 	frame-terminal
frame-terminal-default-bg-mode 	frame-text-cols
frame-text-height 	frame-text-lines
frame-text-width 	frame-total-cols
frame-visible-p 	frame-width
framep 	framep-on-display
frames-on-display-list 	frameset--jump-to-register
frameset-frame-id 	frameset-frame-id-equal-p
frameset-frame-with-id 	frameset-restore
frameset-save 	frameset-to-register
frexp 	fringe--check-style
fringe-bitmap-p 	fringe-bitmaps-at-pos
fringe-columns 	fringe-mode
fringe-mode-initialize 	fringe-query-style
fround 	fset
ftp 	ftruncate
full-calc 	full-calc-keypad
funcall 	function
function-called-at-point 	function-equal
function-get 	function-put
functionp 	fundamental-mode
gap-position 	gap-size
garbage-collect 	gdb
gdb-enable-debug 	gdb-script-mode
generate-fontset-menu 	generate-new-buffer
generate-new-buffer-name 	generic-char-p
generic-make-keywords-list 	generic-mode
generic-mode-internal 	generic-p
generic-primary-only-one-p 	generic-primary-only-p
get 	get-buffer
get-buffer-create 	get-buffer-process
get-buffer-window 	get-buffer-window-list
get-byte 	get-char-code-property
get-char-property 	get-char-property-and-overlay
get-charset-property 	get-device-terminal
get-file-buffer 	get-file-char
get-free-disk-space 	get-internal-run-time
get-language-info 	get-largest-window
get-load-suffixes 	get-lru-window
get-mru-window 	get-next-valid-buffer
get-other-frame 	get-pos-property
get-process 	get-register
get-scroll-bar-mode 	get-text-property
get-unicode-property-internal 	get-unused-category
get-unused-iso-final-char 	get-upcase-table
get-window-with-predicate 	getenv
getenv-internal 	gethash
gfile-add-watch 	gfile-rm-watch
glasses-mode 	global-auto-complete-mode
global-auto-composition-mode 	global-auto-revert-mode
global-cwarn-mode 	global-ede-mode
global-font-lock-mode 	global-font-lock-mode-check-buffers
global-font-lock-mode-cmhh 	global-font-lock-mode-enable-in-buffers
global-hi-lock-mode 	global-highlight-changes-mode
global-hl-line-mode 	global-key-binding
global-linum-mode 	global-prettify-symbols-mode
global-prettify-symbols-mode-check-buffers
global-prettify-symbols-mode-cmhh
global-prettify-symbols-mode-enable-in-buffers
global-reveal-mode 	global-set-key
global-subword-mode 	global-superword-mode
global-unset-key 	global-visual-line-mode
global-visual-line-mode-check-buffers 	global-visual-line-mode-cmhh
global-visual-line-mode-enable-in-buffers
global-whitespace-mode 	global-whitespace-newline-mode
global-whitespace-toggle-options 	glyph-char
glyph-face 	glyphless-set-char-table-range
gmm-error 	gmm-message
gmm-regexp-concat 	gmm-tool-bar-from-list
gmm-widget-p 	gmm-write-region
gnus 	gnus-add-configuration
gnus-add-text-properties-when 	gnus-add-to-sorted-list
gnus-agent-batch 	gnus-agent-batch-fetch
gnus-agent-delete-group 	gnus-agent-find-parameter
gnus-agent-get-undownloaded-list 	gnus-agent-possibly-alter-active
gnus-agent-possibly-save-gcc 	gnus-agent-regenerate
gnus-agent-rename-group 	gnus-agentize
gnus-alist-pull 	gnus-alive-p
gnus-and 	gnus-annotation-in-region-p
gnus-article-html 	gnus-article-outlook-deuglify-article
gnus-article-outlook-repair-attribution 	gnus-article-outlook-unwrap-lines
gnus-article-prepare-display 	gnus-atomic-progn
gnus-atomic-progn-assign 	gnus-atomic-setq
gnus-batch-kill 	gnus-batch-score
gnus-bind-print-variables 	gnus-bookmark-bmenu-list
gnus-bookmark-jump 	gnus-bookmark-set
gnus-bound-and-true-p 	gnus-boundp
gnus-buffer-exists-p 	gnus-buffer-live-p
gnus-button-mailto 	gnus-button-reply
gnus-byte-compile 	gnus-cache-delete-group
gnus-cache-file-contents 	gnus-cache-generate-active
gnus-cache-generate-nov-databases 	gnus-cache-rename-group
gnus-completing-read 	gnus-convert-article-to-rmail
gnus-convert-face-to-png 	gnus-convert-png-to-face
gnus-copy-file 	gnus-create-hash-size
gnus-create-info-command 	gnus-date-get-time
gnus-date-iso8601 	gnus-dd-mmm
gnus-declare-backend 	gnus-decode-newsgroups
gnus-define-keymap 	gnus-define-keys
gnus-define-keys-1 	gnus-define-keys-safe
gnus-delay-article 	gnus-delay-initialize
gnus-delay-send-queue 	gnus-delete-alist
gnus-delete-directory 	gnus-delete-duplicates
gnus-delete-file 	gnus-delete-first
gnus-delete-line 	gnus-draft-reminder
gnus-emacs-completing-read 	gnus-emacs-version
gnus-error 	gnus-eval-in-buffer-window
gnus-extract-address-components 	gnus-extract-references
gnus-face-from-file 	gnus-faces-at
gnus-fetch-field 	gnus-fetch-group
gnus-fetch-group-other-frame 	gnus-fetch-original-field
gnus-file-newer-than 	gnus-final-warning
gnus-find-text-property-region 	gnus-float-time
gnus-frame-or-window-display-name 	gnus-get-buffer-window
gnus-get-display-table
gnus-get-text-property-excluding-characters-with-faces
gnus-globalify-regexp 	gnus-goto-char
gnus-goto-colon 	gnus-graphic-display-p
gnus-grep-in-list 	gnus-group-real-name
gnus-group-server 	gnus-group-split
gnus-group-split-fancy 	gnus-group-split-setup
gnus-group-split-update 	gnus-horizontal-recenter
gnus-html-prefetch-images 	gnus-ido-completing-read
gnus-insert-random-x-face-header 	gnus-intern-safe
gnus-intersection 	gnus-invisible-p
gnus-iswitchb-completing-read 	gnus-jog-cache
gnus-list-memq-of-list 	gnus-local-set-keys
gnus-mailing-list-insinuate 	gnus-mailing-list-mode
gnus-make-directory 	gnus-make-hashtable
gnus-make-local-hook 	gnus-make-predicate
gnus-make-predicate-1 	gnus-make-sort-function
gnus-make-sort-function-1 	gnus-map-function
gnus-mapcar 	gnus-match-substitute-replacement
gnus-merge 	gnus-message
gnus-message-with-timestamp 	gnus-mode-string-quote
gnus-msg-mail 	gnus-multiple-choice
gnus-newsgroup-directory-form 	gnus-newsgroup-savable-name
gnus-next-char-property-change 	gnus-no-server
gnus-not-ignore 	gnus-notifications
gnus-or 	gnus-other-frame
gnus-outlook-deuglify-article 	gnus-output-to-mail
gnus-output-to-rmail 	gnus-parent-id
gnus-parse-without-error 	gnus-plugged
gnus-pp 	gnus-pp-to-string
gnus-previous-char-property-change 	gnus-prin1
gnus-prin1-to-string 	gnus-put-display-table
gnus-put-overlay-excluding-newlines
gnus-put-text-property-excluding-characters-with-faces
gnus-put-text-property-excluding-newlines
gnus-random-x-face 	gnus-read-event-char
gnus-read-shell-command 	gnus-recursive-directory-files
gnus-registry-initialize 	gnus-registry-install-hooks
gnus-remassoc 	gnus-remove-if
gnus-remove-if-not 	gnus-remove-text-properties-when
gnus-remove-text-with-property 	gnus-rename-file
gnus-replace-in-string 	gnus-rescale-image
gnus-run-hook-with-args 	gnus-run-hooks
gnus-run-mode-hooks 	gnus-score-mode
gnus-seconds-month 	gnus-seconds-today
gnus-seconds-year 	gnus-select-frame-set-input-focus
gnus-set-file-modes 	gnus-set-process-query-on-exit-flag
gnus-set-sorted-intersection 	gnus-set-window-start
gnus-set-work-buffer 	gnus-sieve-article-add-rule
gnus-sieve-generate 	gnus-sieve-update
gnus-slave 	gnus-slave-no-server
gnus-slave-unplugged 	gnus-sorted-complement
gnus-sorted-difference 	gnus-sorted-intersection
gnus-sorted-ndifference 	gnus-sorted-nintersection
gnus-sorted-nunion 	gnus-sorted-range-intersection
gnus-sorted-union 	gnus-split-references
gnus-string-equal 	gnus-string-match-p
gnus-string-prefix-p 	gnus-string-remove-all-properties
gnus-string< 	gnus-string>
gnus-strip-whitespace 	gnus-summary-bookmark-jump
gnus-sync-initialize 	gnus-sync-install-hooks
gnus-time-iso8601 	gnus-timer--function
gnus-tool-bar-update 	gnus-treat-from-gravatar
gnus-treat-from-picon 	gnus-treat-mail-gravatar
gnus-treat-mail-picon 	gnus-treat-newsgroups-picon
gnus-turn-off-edit-menu 	gnus-union
gnus-unplugged 	gnus-update-alist-soft
gnus-update-format 	gnus-url-unhex
gnus-url-unhex-string 	gnus-user-format-function-D
gnus-user-format-function-d 	gnus-with-output-to-file
gnus-write-active-file 	gnus-write-buffer
gnus-x-face-from-file 	gnus-y-or-n-p
gnus-yes-or-no-p 	gnutls-available-p
gnutls-boot 	gnutls-bye
gnutls-deinit 	gnutls-error-fatalp
gnutls-error-string 	gnutls-errorp
gnutls-get-initstage 	gomoku
google-translate--bit-v-2comp 	google-translate--bit-v-to-number
google-translate--current-direction-source-language
google-translate--current-direction-target-language
google-translate--detailed-definition 	google-translate--detailed-translation
google-translate--format-listen-url 	google-translate--format-query-string
google-translate--format-request-url 	google-translate--gen-rl
google-translate--gen-tk 	google-translate--get-b-d1
google-translate--http-response-body 	google-translate--insert-nulls
google-translate--listen-action 	google-translate--listen-button
google-translate--logand 	google-translate--logfn
google-translate--logxor 	google-translate--lsh
google-translate--number-to-bit-v 	google-translate--read-from-minibuffer
google-translate--request 	google-translate--search-tkk
google-translate--setup-minibuffer-keymap
google-translate--strip-string 	google-translate--suggestion
google-translate--suggestion-action 	google-translate--text-phonetic
google-translate--translated-text 	google-translate--translating-text
google-translate--translation-phonetic 	google-translate--translation-title
google-translate--trim-string 	google-translate-at-point
google-translate-at-point-reverse
google-translate-buffer-insert-translation
google-translate-buffer-output-translation
google-translate-change-translation-direction
google-translate-clear-minibuffer 	google-translate-completing-read
google-translate-echo-area-output-translation
google-translate-find-preferable-input-method
google-translate-format-listen-url
google-translate-help-buffer-output-translation
google-translate-insert-translation
google-translate-json-detailed-definition
google-translate-json-detailed-translation
google-translate-json-suggestion 	google-translate-json-text-phonetic
google-translate-json-translation
google-translate-json-translation-phonetic
google-translate-kill-ring-output-translation
google-translate-language-abbreviation 	google-translate-language-display-name
google-translate-listen-translation
google-translate-next-translation-direction
google-translate-paragraph
google-translate-popup-output-translation
google-translate-prepare-text-for-request
google-translate-previous-translation-direction
google-translate-query-translate 	google-translate-query-translate-reverse
google-translate-query-translate-using-directions
google-translate-read-args 	google-translate-read-source-language
google-translate-read-target-language 	google-translate-request
google-translate-setup-preferable-input-method
google-translate-smooth-translate 	google-translate-supported-languages
google-translate-translate 	google-translate-version
goto-address 	goto-address-at-mouse
goto-address-at-point 	goto-address-mode
goto-address-prog-mode 	goto-char
goto-history-element 	goto-line
goto-next-locus 	gpm-mouse-mode
gpm-mouse-start 	gpm-mouse-stop
gravatar-retrieve 	gravatar-retrieve-synchronously
grep 	grep-compute-defaults
grep-find 	grep-mode
grep-process-setup 	group-gid
group-real-gid 	gs-load-image
gtos-auto-detected-language 	gtos-detailed-definition
gtos-detailed-translation 	gtos-p
gtos-source-language 	gtos-suggestion
gtos-target-language 	gtos-text
gtos-text-phonetic 	gtos-translation
gtos-translation-phonetic 	gud-gdb
gud-tooltip-mode 	gv--defun-declaration
gv-define-expander 	gv-define-setter
gv-define-simple-setter 	gv-get
gv-letplace 	gv-ref
hack-dir-local-variables 	hack-dir-local-variables-non-file-buffer
hack-local-variables 	hack-local-variables-apply
hack-local-variables-confirm 	hack-local-variables-filter
hack-local-variables-prop-line 	hack-one-local-variable
hack-one-local-variable--obsolete 	hack-one-local-variable-constantp
hack-one-local-variable-eval-safep 	hack-one-local-variable-quotep
handle-delete-frame 	handle-focus-in
handle-focus-out 	handle-save-session
handle-select-window 	handle-shift-selection
handle-switch-frame 	handwrite
hangul-input-method-activate 	hanoi
hanoi-unix 	hanoi-unix-64
hash-table-count 	hash-table-p
hash-table-rehash-size 	hash-table-rehash-threshold
hash-table-size 	hash-table-test
hash-table-weakness 	hashcash-insert-payment
hashcash-insert-payment-async 	hashcash-verify-payment
hebrew-font-get-precomposed 	hebrew-shape-gstring
help 	help-C-file-name
help-add-fundoc-usage 	help-at-pt-cancel-timer
help-at-pt-kbd-string 	help-at-pt-set-timer
help-at-pt-string 	help-bookmark-jump
help-bookmark-make-record 	help-buffer
help-button-action 	help-command
help-describe-category-set 	help-do-arg-highlight
help-do-xref 	help-fns--autoloaded-p
help-fns--compiler-macro 	help-fns--key-bindings
help-fns--obsolete 	help-fns--parent-mode
help-fns--signature 	help-follow
help-follow-mouse 	help-follow-symbol
help-for-help 	help-for-help-internal
help-for-help-internal-doc 	help-form-show
help-function-arglist 	help-go-back
help-go-forward 	help-highlight-arg
help-highlight-arguments 	help-insert-string
help-insert-xref-button 	help-key-description
help-make-usage 	help-make-xrefs
help-mode 	help-mode-finish
help-mode-menu 	help-mode-revert-buffer
help-mode-setup 	help-print-return-message
help-quit 	help-setup-xref
help-split-fundoc 	help-window-display-message
help-window-setup 	help-with-tutorial
help-with-tutorial-spec-language 	help-xref-button
help-xref-go-back 	help-xref-go-forward
help-xref-interned 	help-xref-on-pp
hexl-find-file 	hexl-mode
hexlify-buffer 	hi-lock-face-buffer
hi-lock-face-phrase-buffer 	hi-lock-face-symbol-at-point
hi-lock-line-face-buffer 	hi-lock-mode
hi-lock-unface-buffer 	hi-lock-write-interactive-patterns
hide-ifdef-mode 	highlight-changes-mode
highlight-changes-next-change 	highlight-changes-previous-change
highlight-changes-remove-highlight 	highlight-changes-rotate-faces
highlight-changes-visible-mode 	highlight-compare-buffers
highlight-compare-with-file 	highlight-lines-matching-regexp
highlight-phrase 	highlight-regexp
highlight-symbol-at-point 	hippie-expand
hl-line-mode 	holiday-list
holidays 	how-many
hs-minor-mode 	html-mode
html2text 	htmlfontify-buffer
htmlfontify-copy-and-link-dir 	ibuffer
ibuffer-list-buffers 	ibuffer-other-window
icalendar-export-file 	icalendar-export-region
icalendar-import-buffer 	icalendar-import-file
icomplete-mode 	icon-mode
iconify-frame 	iconify-or-deiconify-frame
identity 	idl-mode
idlwave-mode 	idlwave-shell
ido-active 	ido-add-virtual-buffers-to-list
ido-all-completions 	ido-buffer-internal
ido-buffer-window-other-frame 	ido-cache-ftp-valid
ido-cache-unc-valid 	ido-choose-completion-string
ido-chop 	ido-common-initialization
ido-complete 	ido-complete-space
ido-completing-read 	ido-completion-help
ido-completions 	ido-copy-current-file-name
ido-copy-current-word 	ido-delete-backward-updir
ido-delete-backward-word-updir 	ido-delete-file-at-head
ido-directory-too-big-p 	ido-dired
ido-display-buffer 	ido-display-file
ido-edit-input 	ido-enter-dired
ido-enter-find-file 	ido-enter-insert-buffer
ido-enter-insert-file 	ido-enter-switch-buffer
ido-everywhere 	ido-exhibit
ido-existing-item-p 	ido-exit-minibuffer
ido-expand-directory 	ido-fallback-command
ido-file-extension-aux 	ido-file-extension-lessp
ido-file-extension-order 	ido-file-internal
ido-file-lessp 	ido-file-name-all-completions
ido-file-name-all-completions-1 	ido-final-slash
ido-find-alternate-file 	ido-find-common-substring
ido-find-file 	ido-find-file-in-dir
ido-find-file-other-frame 	ido-find-file-other-window
ido-find-file-read-only 	ido-find-file-read-only-other-frame
ido-find-file-read-only-other-window 	ido-flatten-merged-list
ido-forget-work-directory 	ido-fractionp
ido-get-buffers-in-frames 	ido-get-bufname
ido-get-work-directory 	ido-get-work-file
ido-ignore-item-p 	ido-init-completion-maps
ido-initiate-auto-merge 	ido-insert-buffer
ido-insert-file 	ido-is-ftp-directory
ido-is-root-directory 	ido-is-slow-ftp-host
ido-is-tramp-root 	ido-is-unc-host
ido-is-unc-root 	ido-kill-buffer
ido-kill-buffer-at-head 	ido-kill-emacs-hook
ido-list-directory 	ido-load-history
ido-local-file-exists-p 	ido-magic-backward-char
ido-magic-delete-char 	ido-magic-forward-char
ido-make-buffer-list 	ido-make-buffer-list-1
ido-make-choice-list 	ido-make-dir-list
ido-make-dir-list-1 	ido-make-directory
ido-make-file-list 	ido-make-file-list-1
ido-make-merged-file-list 	ido-make-merged-file-list-1
ido-make-prompt 	ido-makealist
ido-may-cache-directory 	ido-merge-work-directories
ido-minibuffer-setup 	ido-mode
ido-name 	ido-next-match
ido-next-match-dir 	ido-next-work-directory
ido-next-work-file 	ido-no-final-slash
ido-nonreadable-directory-p 	ido-pop-dir
ido-pp 	ido-prev-match
ido-prev-match-dir 	ido-prev-work-directory
ido-prev-work-file 	ido-push-dir
ido-push-dir-first 	ido-read-buffer
ido-read-directory-name 	ido-read-file-name
ido-read-internal 	ido-record-command
ido-record-work-directory 	ido-record-work-file
ido-remove-cached-dir 	ido-reread-directory
ido-restrict-to-matches 	ido-save-history
ido-select-text 	ido-set-common-completion
ido-set-current-directory 	ido-set-current-home
ido-set-matches 	ido-set-matches-1
ido-setup-completion-map 	ido-sort-merged-list
ido-summary-buffers-to-end 	ido-switch-buffer
ido-switch-buffer-other-frame 	ido-switch-buffer-other-window
ido-take-first-match 	ido-tidy
ido-time-stamp 	ido-to-end
ido-toggle-case 	ido-toggle-ignore
ido-toggle-literal 	ido-toggle-prefix
ido-toggle-regexp 	ido-toggle-trace
ido-toggle-vc 	ido-toggle-virtual-buffers
ido-trace 	ido-unc-hosts
ido-unc-hosts-net-view 	ido-undo-merge-work-directory
ido-unload-function 	ido-up-directory
ido-visit-buffer 	ido-wash-history
ido-wide-find-dir 	ido-wide-find-dir-or-delete-dir
ido-wide-find-dirs-or-files 	ido-wide-find-file
ido-wide-find-file-or-pop-dir 	ido-word-matching-substring
ido-write-file 	ielm
if 	ifconfig
ignore 	ignore-errors
iimage-mode 	image-animate
image-animate-get-speed 	image-animate-set-speed
image-animate-timeout 	image-animate-timer
image-animated-p 	image-bookmark-jump
image-current-frame 	image-dired
image-dired-delete-tag 	image-dired-dired-comment-files
image-dired-dired-display-external 	image-dired-dired-display-image
image-dired-dired-edit-comment-and-tags 	image-dired-dired-toggle-marked-thumbs
image-dired-dired-with-window-configuration
image-dired-display-thumb 	image-dired-display-thumbs
image-dired-display-thumbs-append 	image-dired-jump-thumbnail-buffer
image-dired-mark-tagged-files 	image-dired-setup-dired-keybindings
image-dired-show-all-from-dir 	image-dired-tag-files
image-extension-data 	image-file-name-regexp
image-flush 	image-jpeg-p
image-load-path-for-library 	image-mask-p
image-metadata 	image-minor-mode
image-mode 	image-mode-as-text
image-multi-frame-p 	image-refresh
image-search-load-path 	image-show-frame
image-size 	image-type
image-type-auto-detected-p 	image-type-available-p
image-type-from-buffer 	image-type-from-data
image-type-from-file-header 	image-type-from-file-name
imagemagick-filter-types 	imagemagick-register-types
imagemagick-types 	imenu
imenu-add-menubar-index 	imenu-add-to-menubar
in-is13194-post-read-conversion 	in-is13194-pre-write-conversion
inactivate-input-method 	increase-left-margin
increase-right-margin 	increment-register
indent-according-to-mode 	indent-accumulate-tab-stops
indent-code-rigidly 	indent-for-comment
indent-for-tab-command 	indent-line-to
indent-new-comment-line 	indent-next-tab-stop
indent-pp-sexp 	indent-region
indent-relative 	indent-relative-maybe
indent-rigidly 	indent-rigidly--current-indentation
indent-rigidly--pop-undo 	indent-rigidly-left
indent-rigidly-left-to-tab-stop 	indent-rigidly-right
indent-rigidly-right-to-tab-stop 	indent-sexp
indent-to 	indent-to-column
indent-to-left-margin 	indented-text-mode
indian-2-column-to-ucs-region 	indian-compose-regexp
indian-compose-region 	indian-compose-string
indicate-copied-region 	indirect-function
indirect-variable 	inferior-lisp
inferior-octave 	inferior-tcl
info 	info-apropos
info-complete-file 	info-complete-symbol
info-display-manual 	info-emacs-bug
info-emacs-manual 	info-finder
info-lookup-file 	info-lookup-reset
info-lookup-symbol 	info-other-window
info-standalone 	info-xref-check
info-xref-check-all 	info-xref-check-all-custom
info-xref-docstrings 	inhibit-local-variables-p
init-image-library 	initialize-instance
inline 	input-pending-p
insert 	insert-abbrev-table-description
insert-abbrevs 	insert-and-inherit
insert-before-markers 	insert-before-markers-and-inherit
insert-buffer 	insert-buffer-substring
insert-buffer-substring-as-yank 	insert-buffer-substring-no-properties
insert-button 	insert-byte
insert-char 	insert-directory
insert-directory-adj-pos 	insert-directory-safely
insert-file 	insert-file-1
insert-file-contents 	insert-file-contents-literally
insert-file-literally 	insert-for-yank
insert-for-yank-1 	insert-image
insert-image-file 	insert-kbd-macro
insert-pair 	insert-parentheses
insert-rectangle 	insert-register
insert-sliced-image 	insert-string
insert-tab 	insert-text-button
int-to-string 	integer-or-marker-p
integerp 	interactive
interactive-form 	interactive-p
intern 	intern-soft
internal--after-save-selected-window 	internal--after-with-selected-window
internal--before-save-selected-window 	internal--before-with-selected-window
internal-char-font 	internal-complete-buffer
internal-complete-buffer-except 	internal-copy-lisp-face
internal-default-process-filter 	internal-default-process-sentinel
internal-describe-syntax-value 	internal-event-symbol-parse-modifiers
internal-face-x-get-resource 	internal-get-lisp-face-attribute
internal-lisp-face-attribute-values 	internal-lisp-face-empty-p
internal-lisp-face-equal-p 	internal-lisp-face-p
internal-macroexpand-for-load 	internal-make-lisp-face
internal-make-var-non-special 	internal-merge-in-global-face
internal-pop-keymap 	internal-push-keymap
internal-set-alternative-font-family-alist
internal-set-alternative-font-registry-alist
internal-set-font-selection-order 	internal-set-lisp-face-attribute
internal-set-lisp-face-attribute-from-resource
internal-show-cursor 	internal-show-cursor-p
internal-temp-output-buffer-show 	internal-timer-start-idle
interrupt-process 	inverse-add-abbrev
inverse-add-global-abbrev 	inverse-add-mode-abbrev
inversion-require-emacs 	invert-face
invisible-p 	invocation-directory
invocation-name 	irc
isInNet 	isPlainHostName
isResolvable 	isearch--get-state
isearch--set-state 	isearch--state-barrier
isearch--state-case-fold-search 	isearch--state-error
isearch--state-forward 	isearch--state-message
isearch--state-other-end 	isearch--state-p
isearch--state-point 	isearch--state-pop-fun
isearch--state-string 	isearch--state-success
isearch--state-word 	isearch--state-wrapped
isearch-abort 	isearch-back-into-window
isearch-backslash 	isearch-backward
isearch-backward-regexp 	isearch-cancel
isearch-char-by-name 	isearch-clean-overlays
isearch-close-unnecessary-overlays 	isearch-complete
isearch-complete-edit 	isearch-complete1
isearch-dehighlight 	isearch-del-char
isearch-delete-char 	isearch-describe-bindings
isearch-describe-key 	isearch-describe-mode
isearch-done 	isearch-edit-string
isearch-exit 	isearch-fail-pos
isearch-fallback 	isearch-filter-visible
isearch-forward 	isearch-forward-exit-minibuffer
isearch-forward-regexp 	isearch-forward-symbol
isearch-forward-symbol-at-point 	isearch-forward-word
isearch-help-for-help 	isearch-help-for-help-internal
isearch-help-for-help-internal-doc 	isearch-highlight
isearch-highlight-regexp 	isearch-intersects-p
isearch-lazy-highlight-cleanup 	isearch-lazy-highlight-new-loop
isearch-lazy-highlight-search 	isearch-lazy-highlight-update
isearch-message 	isearch-message-prefix
isearch-message-suffix 	isearch-mode
isearch-mode-help 	isearch-mouse-2
isearch-no-upper-case-p 	isearch-nonincremental-exit-minibuffer
isearch-occur 	isearch-open-necessary-overlays
isearch-open-overlay-temporary 	isearch-pop-state
isearch-post-command-hook 	isearch-pre-command-hook
isearch-printing-char 	isearch-process-search-char
isearch-process-search-multibyte-characters
isearch-process-search-string 	isearch-push-state
isearch-query-replace 	isearch-query-replace-regexp
isearch-quote-char 	isearch-range-invisible
isearch-repeat 	isearch-repeat-backward
isearch-repeat-forward 	isearch-resume
isearch-reverse-exit-minibuffer 	isearch-ring-adjust
isearch-ring-adjust1 	isearch-ring-advance
isearch-ring-retreat 	isearch-search
isearch-search-and-update 	isearch-search-fun
isearch-search-fun-default 	isearch-search-string
isearch-string-out-of-window 	isearch-symbol-regexp
isearch-text-char-description 	isearch-toggle-case-fold
isearch-toggle-input-method 	isearch-toggle-invisible
isearch-toggle-lax-whitespace 	isearch-toggle-regexp
isearch-toggle-specified-input-method 	isearch-toggle-symbol
isearch-toggle-word 	isearch-unread
isearch-update 	isearch-update-ring
isearch-yank-char 	isearch-yank-char-in-minibuffer
isearch-yank-internal 	isearch-yank-kill
isearch-yank-line 	isearch-yank-pop
isearch-yank-string 	isearch-yank-word
isearch-yank-word-or-char 	isearch-yank-x-selection
isearchb-activate 	isnan
iso-charset 	iso-cvt-define-menu
iso-cvt-read-only 	iso-cvt-write-only
iso-german 	iso-gtex2iso
iso-iso2duden 	iso-iso2gtex
iso-iso2sgml 	iso-iso2tex
iso-sgml2iso 	iso-spanish
iso-tex2iso 	iso-transl-ctl-x-8-map
ispell 	ispell-buffer
ispell-buffer-with-debug 	ispell-change-dictionary
ispell-comments-and-strings 	ispell-complete-word
ispell-complete-word-interior-frag 	ispell-continue
ispell-help 	ispell-kill-ispell
ispell-menu-map 	ispell-message
ispell-minor-mode 	ispell-pdict-save
ispell-region 	ispell-word
iswitchb-mode 	iwconfig
japanese-hankaku 	japanese-hankaku-region
japanese-hiragana 	japanese-hiragana-region
japanese-katakana 	japanese-katakana-region
japanese-zenkaku 	japanese-zenkaku-region
java-mode 	javascript-mode
jdb 	jit-lock--debug-fontify
jit-lock-after-change 	jit-lock-context-fontify
jit-lock-debug-mode 	jit-lock-deferred-fontify
jit-lock-fontify-now 	jit-lock-force-redisplay
jit-lock-function 	jit-lock-mode
jit-lock-refontify 	jit-lock-register
jit-lock-stealth-chunk-start 	jit-lock-stealth-fontify
jit-lock-unregister 	jka-compr-build-file-regexp
jka-compr-get-compression-info 	jka-compr-handler
jka-compr-info-can-append 	jka-compr-info-compress-args
jka-compr-info-compress-message 	jka-compr-info-compress-program
jka-compr-info-file-magic-bytes 	jka-compr-info-regexp
jka-compr-info-strip-extension 	jka-compr-info-uncompress-args
jka-compr-info-uncompress-message 	jka-compr-info-uncompress-program
jka-compr-install 	jka-compr-installed-p
jka-compr-set 	jka-compr-uninstall
jka-compr-update 	join-line
js-mode 	json--with-indentation
json-add-to-object 	json-advance
json-alist-p 	json-decode-char0
json-encode 	json-encode-alist
json-encode-array 	json-encode-char
json-encode-char0 	json-encode-hash-table
json-encode-key 	json-encode-keyword
json-encode-list 	json-encode-number
json-encode-plist 	json-encode-string
json-join 	json-new-object
json-peek 	json-plist-p
json-pop 	json-pretty-print
json-pretty-print-buffer 	json-read
json-read-array 	json-read-escaped-char
json-read-file 	json-read-from-string
json-read-keyword 	json-read-number
json-read-object 	json-read-string
json-skip-whitespace 	jump-to-register
just-one-space 	justify-current-line
kbd 	kbd-macro-query
keep-lines 	keep-lines-read-args
key-binding 	key-description
keyboard-coding-system 	keyboard-escape-quit
keyboard-quit 	keyboard-translate
keymap--menu-item-binding 	keymap--menu-item-with-binding
keymap--merge-bindings 	keymap-canonicalize
keymap-parent 	keymap-prompt
keymapp 	keypad-setup
keywordp 	kill-all-abbrevs
kill-all-local-variables 	kill-append
kill-backward-chars 	kill-backward-up-list
kill-buffer 	kill-buffer-and-window
kill-buffer-ask 	kill-buffer-if-not-modified
kill-comment 	kill-emacs
kill-forward-chars 	kill-line
kill-local-variable 	kill-matching-buffers
kill-new 	kill-paragraph
kill-process 	kill-rectangle
kill-region 	kill-ring-save
kill-sentence 	kill-sexp
kill-some-buffers 	kill-this-buffer
kill-this-buffer-enabled-p 	kill-visual-line
kill-whole-line 	kill-word
kinsoku 	kkc-region
kmacro-call-macro 	kmacro-end-and-call-macro
kmacro-end-call-mouse 	kmacro-end-macro
kmacro-end-or-call-macro 	kmacro-exec-ring-item
kmacro-keymap 	kmacro-start-macro
kmacro-start-macro-or-insert-counter 	lambda
landmark 	landmark-repeat
landmark-test-run 	lao-compose-region
lao-compose-string 	lao-composition-function
lao-transcribe-roman-to-lao-string
lao-transcribe-single-roman-syllable-to-lao
last 	last-buffer
last-nonminibuffer-frame 	last-sexp-setup-props
last-sexp-toggle-display 	latex-mode
latexenc-coding-system-to-inputenc 	latexenc-find-file-coding-system
latexenc-inputenc-to-coding-system 	latin1-display
lax-plist-get 	lax-plist-put
lazy-completion-table 	lazy-highlight-cleanup
ld-script-mode 	ldexp
left-char 	left-word
length 	let
let* 	letrec
lglyph-adjustment 	lglyph-ascent
lglyph-char 	lglyph-code
lglyph-copy 	lglyph-descent
lglyph-from 	lglyph-lbearing
lglyph-rbearing 	lglyph-set-adjustment
lglyph-set-char 	lglyph-set-code
lglyph-set-from-to 	lglyph-set-width
lglyph-to 	lglyph-width
lgrep 	lgstring-char
lgstring-char-len 	lgstring-font
lgstring-glyph 	lgstring-glyph-len
lgstring-header 	lgstring-insert-glyph
lgstring-set-glyph 	lgstring-set-header
lgstring-set-id 	lgstring-shaped-p
libxml-parse-html-region 	libxml-parse-xml-region
life 	line-beginning-position
line-end-position 	line-move
line-move-1 	line-move-finish
line-move-partial 	line-move-to-column
line-move-visual 	line-number-at-pos
line-number-mode 	line-pixel-height
linum-mode 	lisp--company-doc-buffer
lisp--company-doc-string 	lisp--company-location
lisp--local-variables 	lisp--local-variables-1
lisp-comment-indent 	lisp-complete-symbol
lisp-completion-at-point 	lisp-current-defun-name
lisp-eval-defun 	lisp-fill-paragraph
lisp-find-tag-default 	lisp-font-lock-syntactic-face-function
lisp-indent-defform 	lisp-indent-function
lisp-indent-line 	lisp-indent-specform
lisp-interaction-mode 	lisp-mode
lisp-mode-auto-fill 	lisp-mode-variables
lisp-outline-level 	list
list-abbrevs 	list-at-point
list-bookmarks 	list-buffers
list-buffers--refresh 	list-buffers-noselect
list-character-sets 	list-charset-chars
list-coding-categories 	list-coding-systems
list-colors-display 	list-colors-duplicates
list-colors-print 	list-colors-redisplay
list-colors-sort-key 	list-command-history
list-directory 	list-dynamic-libraries
list-faces-display 	list-fonts
list-fontsets 	list-holidays
list-input-methods 	list-load-path-shadows
list-matching-lines 	list-packages
list-processes 	list-processes--refresh
list-registers 	list-system-processes
list-tags 	list-yahrzeit-dates
listify-key-sequence 	listp
load 	load-average
load-file 	load-history-filename-element
load-history-regexp 	load-library
load-theme 	load-with-code-conversion
local-key-binding 	local-set-key
local-unset-key 	local-variable-if-set-p
local-variable-p 	locale-charset-match-p
locale-charset-to-coding-system 	locale-info
locale-name-match 	locale-translate
locate 	locate-dominating-file
locate-file 	locate-file-completion
locate-file-completion-table 	locate-file-internal
locate-library 	locate-user-emacs-file
locate-with-filter 	lock-buffer
log 	log-edit
log-view-mode 	log10
logand 	logb
logior 	lognot
logxor 	looking-at
looking-at-p 	looking-back
lookup-image-map 	lookup-key
lookup-minor-mode-from-indicator 	lookup-nested-alist
lower-frame 	lpr-buffer
lpr-customize 	lpr-region
lsh 	lunar-phases
lwarn 	m2-mode
m4-mode 	macro-declaration-function
macroexp--accumulate 	macroexp--all-clauses
macroexp--all-forms 	macroexp--backtrace
macroexp--compiler-macro 	macroexp--compiling-p
macroexp--cons 	macroexp--const-symbol-p
macroexp--expand-all 	macroexp--funcall-if-compiled
macroexp--maxsize 	macroexp--obsolete-warning
macroexp--trim-backtrace-frame 	macroexp--warn-and-return
macroexp-const-p 	macroexp-copyable-p
macroexp-if 	macroexp-let*
macroexp-let2 	macroexp-progn
macroexp-small-p 	macroexp-unprogn
macroexpand 	macroexpand-all
macrop 	mail
mail-abbrevs-mode 	mail-abbrevs-setup
mail-add-payment 	mail-add-payment-async
mail-check-payment 	mail-complete
mail-completion-at-point-function 	mail-extract-address-components
mail-fetch-field 	mail-file-babyl-p
mail-header-extract 	mail-header-parse-content-type
mail-header-remove-comments 	mail-hist-define-keys
mail-hist-enable 	mail-hist-put-headers-into-history
mail-mode 	mail-other-frame
mail-other-window 	mail-quote-printable
mail-quote-printable-region 	mail-unquote-printable
mail-unquote-printable-region 	mailcap-add
mailcap-add-mailcap-entry 	mailcap-command-p
mailcap-delete-duplicates 	mailcap-extension-to-mime
mailcap-file-default-commands 	mailcap-mailcap-entry-passes-test
mailcap-maybe-eval 	mailcap-mime-info
mailcap-mime-types 	mailcap-parse-mailcap
mailcap-parse-mailcap-extras 	mailcap-parse-mailcaps
mailcap-parse-mimetype-file 	mailcap-parse-mimetypes
mailcap-possible-viewers 	mailcap-replace-in-string
mailcap-replace-regexp 	mailcap-save-binary-file
mailcap-unescape-mime-test 	mailcap-viewer-lessp
mailcap-viewer-passes-test 	mailclient-send-it
make-abbrev-table 	make-auto-save-file-name
make-backup-file-name 	make-backup-file-name--default-function
make-backup-file-name-1 	make-bool-vector
make-button 	make-byte-code
make-category-set 	make-category-table
make-char 	make-char-internal
make-char-table 	make-coding-system
make-comint 	make-comint-in-buffer
make-command-summary 	make-composed-keymap
make-directory 	make-directory-internal
make-display-table 	make-empty-face
make-face 	make-face-bold
make-face-bold-italic 	make-face-italic
make-face-unbold 	make-face-unitalic
make-face-x-resource-internal 	make-frame
make-frame-command 	make-frame-invisible
make-frame-names-alist 	make-frame-on-display
make-frame-visible 	make-glyph-code
make-gtos 	make-hash-table
make-hippie-expand-function 	make-indirect-buffer
make-initial-minibuffer-frame 	make-instance
make-keymap 	make-list
make-local-variable 	make-marker
make-mode-line-mouse-map 	make-network-process
make-obsolete 	make-obsolete-variable
make-overlay 	make-package--ac-desc
make-package--bi-desc 	make-progress-reporter
make-ring 	make-serial-process
make-sparse-keymap 	make-string
make-symbol 	make-symbolic-link
make-syntax-table 	make-temp-file
make-temp-name 	make-term
make-terminal-frame 	make-text-button
make-translation-table 	make-translation-table-from-alist
make-translation-table-from-vector 	make-variable-buffer-local
make-variable-frame-local 	make-vc-git-extra-fileinfo
make-vector 	makefile-automake-mode
makefile-bsdmake-mode 	makefile-gmake-mode
makefile-imake-mode 	makefile-makepp-mode
makefile-mode 	makehash
makunbound 	man
man-follow 	manual-entry
map-char-table 	map-charset-chars
map-keymap 	map-keymap-internal
map-keymap-sorted 	map-query-replace-regexp
map-y-or-n-p 	mapatoms
mapc 	mapcar
mapconcat 	maphash
mark 	mark-defun
mark-end-of-sentence 	mark-marker
mark-page 	mark-paragraph
mark-sexp 	mark-whole-buffer
mark-word 	marker-buffer
marker-insertion-type 	marker-position
markerp 	master-mode
match-beginning 	match-data
match-end 	match-string
match-string-no-properties 	match-substitute-replacement
matching-paren 	max
max-char 	maximize-window
md5 	member
member-ignore-case 	memory-limit
memory-use-counts 	memq
memql 	menu-bar-bookmark-map
menu-bar-ediff-menu 	menu-bar-ediff-merge-menu
menu-bar-ediff-misc-menu 	menu-bar-enable-clipboard
menu-bar-epatch-menu 	menu-bar-frame-for-menubar
menu-bar-kill-ring-save 	menu-bar-left-scroll-bar
menu-bar-make-mm-toggle 	menu-bar-make-toggle
menu-bar-menu-at-x-y 	menu-bar-menu-frame-live-and-visible-p
menu-bar-mode 	menu-bar-next-tag
menu-bar-next-tag-other-window 	menu-bar-no-scroll-bar
menu-bar-non-minibuffer-window-p 	menu-bar-open
menu-bar-options-save 	menu-bar-positive-p
menu-bar-read-lispintro 	menu-bar-read-lispref
menu-bar-read-mail 	menu-bar-right-scroll-bar
menu-bar-select-buffer 	menu-bar-select-frame
menu-bar-select-yank 	menu-bar-set-tool-bar-position
menu-bar-showhide-fringe-ind-box 	menu-bar-showhide-fringe-ind-customize
menu-bar-showhide-fringe-ind-left 	menu-bar-showhide-fringe-ind-mixed
menu-bar-showhide-fringe-ind-none 	menu-bar-showhide-fringe-ind-right
menu-bar-showhide-fringe-menu-customize
menu-bar-showhide-fringe-menu-customize-disable
menu-bar-showhide-fringe-menu-customize-left
menu-bar-showhide-fringe-menu-customize-reset
menu-bar-showhide-fringe-menu-customize-right
menu-bar-showhide-tool-bar-menu-customize-disable
menu-bar-showhide-tool-bar-menu-customize-enable-bottom
menu-bar-showhide-tool-bar-menu-customize-enable-left
menu-bar-showhide-tool-bar-menu-customize-enable-right
menu-bar-showhide-tool-bar-menu-customize-enable-top
menu-bar-update-buffers 	menu-bar-update-buffers-1
menu-bar-update-yank-menu 	menu-find-file-existing
menu-or-popup-active-p 	menu-set-font
mercury-mode 	merge-coding-systems
merge-face-attribute 	message
message-bold-region 	message-bounce
message-box 	message-cancel-news
message-followup 	message-forward
message-forward-make-body 	message-forward-rmail-make-body
message-insinuate-rmail 	message-mail
message-mail-other-frame 	message-mail-other-window
message-mode 	message-news
message-news-other-frame 	message-news-other-window
message-or-box 	message-recover
message-reply 	message-resend
message-supersede 	message-unbold-region
message-wide-reply 	messages-buffer
messages-buffer-mode 	metafont-mode
metamail-buffer 	metamail-interpret-body
metamail-interpret-header 	metamail-region
metapost-mode 	mh-folder-mode
mh-fully-kill-draft 	mh-nmail
mh-rmail 	mh-send-letter
mh-smail 	mh-smail-batch
mh-smail-other-window 	mh-user-agent-compose
mh-version 	midnight-delay-set
min 	minibuffer--bitset
minibuffer--double-dollars 	minibuffer-avoid-prompt
minibuffer-complete 	minibuffer-complete-and-exit
minibuffer-complete-word 	minibuffer-completion-contents
minibuffer-completion-help 	minibuffer-contents
minibuffer-contents-no-properties 	minibuffer-default-add-completions
minibuffer-default-add-shell-commands 	minibuffer-depth
minibuffer-depth-indicate-mode 	minibuffer-electric-default-mode
minibuffer-force-complete 	minibuffer-force-complete-and-exit
minibuffer-frame-list 	minibuffer-hide-completions
minibuffer-history-initialize 	minibuffer-history-isearch-end
minibuffer-history-isearch-message 	minibuffer-history-isearch-pop-state
minibuffer-history-isearch-push-state 	minibuffer-history-isearch-search
minibuffer-history-isearch-setup 	minibuffer-history-isearch-wrap
minibuffer-inactive-mode 	minibuffer-insert-file-name-at-point
minibuffer-message 	minibuffer-prompt
minibuffer-prompt-end 	minibuffer-prompt-width
minibuffer-selected-window 	minibuffer-window
minibuffer-window-active-p 	minibuffer-with-setup-hook
minibufferp 	minimize-window
minor-mode-key-binding 	minor-mode-menu-from-indicator
mixal-mode 	mkdir
mm-annotationp 	mm-append-to-file
mm-auto-mode-alist 	mm-char-int
mm-char-or-char-int-p 	mm-charset-after
mm-charset-to-coding-system 	mm-codepage-setup
mm-coding-system-equal 	mm-coding-system-list
mm-coding-system-p 	mm-coding-system-to-mime-charset
mm-decode-coding-region 	mm-decode-coding-string
mm-decompress-buffer 	mm-default-file-encoding
mm-default-multibyte-p 	mm-delete-duplicates
mm-detect-coding-region 	mm-detect-mime-charset-region
mm-disable-multibyte 	mm-enable-multibyte
mm-encode-coding-region 	mm-encode-coding-string
mm-enrich-utf-8-by-mule-ucs 	mm-extern-cache-contents
mm-find-buffer-file-coding-system 	mm-find-charset-region
mm-find-mime-charset-region 	mm-get-coding-system-list
mm-guess-charset 	mm-image-load-path
mm-inline-external-body 	mm-inline-partial
mm-insert-byte 	mm-insert-file-contents
mm-iso-8859-x-to-15-region 	mm-line-number-at-pos
mm-make-temp-file 	mm-mime-charset
mm-mule-charset-to-mime-charset 	mm-multibyte-char-to-unibyte
mm-multibyte-p 	mm-multibyte-string-p
mm-preferred-coding-system 	mm-read-charset
mm-read-coding-system 	mm-replace-in-string
mm-set-buffer-file-coding-system 	mm-set-buffer-multibyte
mm-setup-codepage-ibm 	mm-setup-codepage-iso-8859
mm-sort-coding-systems-predicate 	mm-special-display-p
mm-string-as-multibyte 	mm-string-as-unibyte
mm-string-make-unibyte 	mm-string-to-multibyte
mm-subst-char-in-string 	mm-substring-no-properties
mm-ucs-to-char 	mm-url-insert-file-contents
mm-url-insert-file-contents-external 	mm-uu-dissect
mm-uu-dissect-text-parts 	mm-with-multibyte-buffer
mm-with-unibyte-buffer 	mm-with-unibyte-current-buffer
mm-write-region 	mm-xemacs-find-mime-charset
mm-xemacs-find-mime-charset-1 	mml-attach-file
mml-to-mime 	mml1991-encrypt
mml1991-sign 	mml2015-decrypt
mml2015-decrypt-test 	mml2015-encrypt
mml2015-self-encrypt 	mml2015-sign
mml2015-verify 	mml2015-verify-test
mod 	mode-line-bury-buffer
mode-line-change-eol 	mode-line-eol-desc
mode-line-frame-control 	mode-line-minor-mode-help
mode-line-modified-help-echo 	mode-line-mule-info-help-echo
mode-line-next-buffer 	mode-line-other-buffer
mode-line-previous-buffer 	mode-line-read-only-help-echo
mode-line-toggle-modified 	mode-line-toggle-read-only
mode-line-unbury-buffer 	mode-line-widen
mode-specific-command-prefix 	modify-all-frames-parameters
modify-category-entry 	modify-coding-system-alist
modify-face 	modify-frame-parameters
modify-syntax-entry 	modula-2-mode
momentary-string-display 	morse-region
mouse--down-1-maybe-follows-link 	mouse--drag-set-mark-and-point
mouse--strip-first-event 	mouse-appearance-menu
mouse-autoselect-window-cancel 	mouse-autoselect-window-select
mouse-autoselect-window-start 	mouse-avoidance-mode
mouse-buffer-menu 	mouse-buffer-menu-alist
mouse-buffer-menu-split 	mouse-choose-completion
mouse-delete-other-windows 	mouse-delete-window
mouse-drag-drag 	mouse-drag-header-line
mouse-drag-line 	mouse-drag-mode-line
mouse-drag-region 	mouse-drag-secondary
mouse-drag-throw 	mouse-drag-track
mouse-drag-vertical-line 	mouse-event-p
mouse-fixup-help-message 	mouse-kill
mouse-kill-ring-save 	mouse-kill-secondary
mouse-major-mode-menu 	mouse-menu-bar-map
mouse-menu-major-mode-map 	mouse-menu-non-singleton
mouse-minibuffer-check 	mouse-minor-mode-menu
mouse-movement-p 	mouse-on-link-p
mouse-pixel-position 	mouse-popup-menubar
mouse-popup-menubar-stuff 	mouse-position
mouse-posn-property 	mouse-region-match
mouse-save-then-kill 	mouse-save-then-kill-delete-region
mouse-scroll-subr 	mouse-secondary-save-then-kill
mouse-select-font 	mouse-select-window
mouse-set-font 	mouse-set-mark
mouse-set-mark-fast 	mouse-set-point
mouse-set-region 	mouse-set-region-1
mouse-set-secondary 	mouse-skip-word
mouse-split-window-horizontally 	mouse-split-window-vertically
mouse-start-end 	mouse-start-secondary
mouse-tear-off-window 	mouse-undouble-last-event
mouse-wheel-change-button 	mouse-wheel-mode
mouse-yank-at-click 	mouse-yank-primary
mouse-yank-secondary 	move-beginning-of-line
move-end-of-line 	move-file-to-trash
move-marker 	move-overlay
move-past-close-and-reindent 	move-point-visually
move-to-column 	move-to-left-margin
move-to-tab-stop 	move-to-window-line
move-to-window-line-top-bottom 	mpc
mpuz 	msb-mode
mule-diag 	multi-isearch-buffers
multi-isearch-buffers-regexp 	multi-isearch-files
multi-isearch-files-regexp 	multi-isearch-setup
multi-occur 	multi-occur-in-matching-buffers
multibyte-char-to-unibyte 	multibyte-string-p
mwheel-event-button 	mwheel-event-window
mwheel-filter-click-events 	mwheel-inhibit-click-timeout
mwheel-install 	mwheel-scroll
name-last-kbd-macro 	narrow-to-defun
narrow-to-page 	narrow-to-region
natnump 	nato-region
nbutlast 	nconc
negative-argument 	nested-alist-p
netrc-credentials 	netstat
network-connection 	network-connection-to-service
network-interface-info 	network-interface-list
new-fontset 	new-frame
newline 	newline-and-indent
newline-cache-check 	newsticker-plainview
newsticker-running-p 	newsticker-show-news
newsticker-start 	newsticker-start-ticker
newsticker-ticker-running-p 	newsticker-treeview
next-buffer 	next-button
next-char-property-change 	next-complete-history-element
next-completion 	next-error
next-error-buffer-p 	next-error-find-buffer
next-error-follow-minor-mode 	next-error-follow-mode-post-command-hook
next-error-internal 	next-error-no-select
next-file 	next-frame
next-history-element 	next-line
next-logical-line 	next-match
next-matching-history-element 	next-method-p
next-multiframe-window 	next-overlay-change
next-property-change 	next-read-file-uses-dialog-p
next-single-char-property-change 	next-single-property-change
next-window 	nlistp
nndiary-generate-nov-databases 	nndoc-add-type
nnfolder-generate-active-file 	nnheader-narrow-to-headers
nnheader-replace-chars-in-string 	nnml-generate-nov-databases
no-applicable-method 	no-next-method
nonincremental-re-search-backward 	nonincremental-re-search-forward
nonincremental-repeat-search-backward 	nonincremental-repeat-search-forward
nonincremental-search-backward 	nonincremental-search-forward
noreturn 	normal-about-screen
normal-backup-enable-predicate 	normal-erase-is-backspace-mode
normal-erase-is-backspace-setup-frame 	normal-mode
normal-mouse-startup-screen 	normal-no-mouse-startup-screen
normal-splash-screen 	normal-top-level
normal-top-level-add-subdirs-to-load-path
normal-top-level-add-to-load-path 	not
not-modified 	nreverse
nroff-mode 	nslookup
nslookup-host 	nth
nthcdr 	null
number-at-point 	number-or-marker-p
number-sequence 	number-to-register
number-to-string 	numberp
nxml-enable-unicode-char-name-sets 	nxml-glyph-display-string
nxml-mode 	obj-of-class-p
objc-mode 	object-add-to-list
object-assoc 	object-assoc-list
object-assoc-list-safe 	object-class
object-class-fast 	object-class-name
object-name 	object-name-string
object-of-class-p 	object-p
object-print 	object-remove-from-list
object-set-name-string 	object-slots
object-write 	occur
occur-1 	occur-accumulate-lines
occur-after-change-function 	occur-cease-edit
occur-context-lines 	occur-edit-mode
occur-engine 	occur-engine-add-prefix
occur-engine-line 	occur-find-match
occur-mode 	occur-mode-display-occurrence
occur-mode-find-occurrence 	occur-mode-goto-occurrence
occur-mode-goto-occurrence-other-window 	occur-mode-mouse-goto
occur-next 	occur-next-error
occur-prev 	occur-read-primary-args
occur-rename-buffer 	occur-revert-function
octave-mode 	one-window-p
opascal-mode 	open-dribble-file
open-font 	open-line
open-network-stream 	open-protocol-stream
open-rectangle 	open-termscript
optimize-char-table 	oqwer32
or 	oref
oref-default 	org-agenda
org-agenda-check-for-timestamp-as-reason-to-ignore-todo-item
org-agenda-columns 	org-agenda-list
org-agenda-list-stuck-projects 	org-agenda-set-restriction-lock
org-agenda-to-appt 	org-babel-do-load-languages
org-babel-load-file 	org-batch-agenda
org-batch-agenda-csv 	org-batch-store-agenda-views
org-calendar-goto-agenda 	org-capture
org-capture-import-remember-templates 	org-capture-string
org-check-version 	org-clock-persistence-insinuate
org-columns 	org-columns-compute
org-columns-get-format-and-top-level 	org-columns-number-to-string
org-columns-remove-overlays 	org-customize
org-cycle 	org-cycle-agenda-files
org-dblock-write:columnview 	org-diary
org-git-version 	org-global-cycle
org-ido-switchb 	org-insert-columns-dblock
org-insert-link-global 	org-iswitchb
org-load-noerror-mustsuffix 	org-mode
org-open-at-point-global 	org-open-link-from-string
org-release 	org-reload
org-run-like-in-org-mode 	org-search-view
org-store-agenda-views 	org-store-link
org-submit-bug-report 	org-switchb
org-tags-view 	org-todo-list
org-toggle-sticky-agenda 	org-version
orgstruct-mode 	oset
oset-default 	other-buffer
other-frame 	other-window
other-window-for-scrolling 	outline-minor-mode
outline-mode 	outlineify-sticky
outlinify-sticky 	overlay-buffer
overlay-end 	overlay-get
overlay-lists 	overlay-properties
overlay-put 	overlay-recenter
overlay-start 	overlayp
overlays-at 	overlays-in
overwrite-mode 	package--ac-desc-extras
package--ac-desc-kind 	package--ac-desc-reqs
package--ac-desc-summary 	package--ac-desc-version
package--add-to-archive-contents 	package--alist-to-plist-args
package--archive-file-exists-p 	package--bi-desc-reqs
package--bi-desc-summary 	package--bi-desc-version
package--check-signature 	package--compile
package--description-file 	package--download-one-archive
package--from-builtin 	package--has-keyword-p
package--make-autoloads-and-stuff 	package--mapc
package--prepare-dependencies 	package--push
package--read-archive-file 	package--with-work-buffer
package--write-file-no-coding 	package-activate
package-activate-1 	package-all-keywords
package-archive-base 	package-autoload-ensure-default-file
package-buffer-info 	package-built-in-p
package-compute-transaction 	package-delete
package-desc--keywords 	package-desc-archive
package-desc-create 	package-desc-dir
package-desc-extras 	package-desc-from-define
package-desc-full-name 	package-desc-kind
package-desc-name 	package-desc-p
package-desc-reqs 	package-desc-signed
package-desc-status 	package-desc-suffix
package-desc-summary 	package-desc-version
package-disabled-p 	package-download-transaction
package-generate-autoloads 	package-generate-description-file
package-import-keyring 	package-initialize
package-install 	package-install-button-action
package-install-file 	package-install-from-archive
package-install-from-buffer 	package-installed-p
package-keyword-button-action 	package-list-packages
package-list-packages-no-fetch 	package-load-all-descriptors
package-load-descriptor 	package-make-ac-desc
package-make-builtin 	package-make-button
package-menu--archive-predicate 	package-menu--description-predicate
package-menu--find-upgrades 	package-menu--generate
package-menu--name-predicate 	package-menu--print-info
package-menu--refresh 	package-menu--status-predicate
package-menu--version-predicate 	package-menu-backup-unmark
package-menu-describe-package 	package-menu-execute
package-menu-filter 	package-menu-get-status
package-menu-mark-delete 	package-menu-mark-install
package-menu-mark-obsolete-for-deletion 	package-menu-mark-unmark
package-menu-mark-upgrades 	package-menu-mode
package-menu-quick-help 	package-menu-refresh
package-menu-view-commentary 	package-process-define-package
package-read-all-archive-contents 	package-read-archive-contents
package-read-from-string 	package-refresh-contents
package-show-package-list 	package-strip-rcs-id
package-tar-file-info 	package-unpack
package-untar-buffer 	package-version-join
paragraph-indent-minor-mode 	paragraph-indent-text-mode
parse-colon-path 	parse-partial-sexp
parse-time-string 	pascal-mode
password-cache-add 	password-cache-remove
password-in-cache-p 	password-read
password-read-and-add 	password-read-from-cache
password-reset 	pcase
pcase-let 	pcase-let*
pcomplete 	pcomplete-comint-setup
pcomplete-continue 	pcomplete-expand
pcomplete-expand-and-complete 	pcomplete-help
pcomplete-list 	pcomplete-reverse
pcomplete-shell-setup 	pcomplete/ack
pcomplete/ack-grep 	pcomplete/ag
pcomplete/bzip2 	pcomplete/cd
pcomplete/chgrp 	pcomplete/chown
pcomplete/cvs 	pcomplete/erc-mode/DCC
pcomplete/erc-mode/NOTIFY 	pcomplete/gdb
pcomplete/gzip 	pcomplete/kill
pcomplete/make 	pcomplete/mount
pcomplete/pushd 	pcomplete/rm
pcomplete/rmdir 	pcomplete/rpm
pcomplete/scp 	pcomplete/ssh
pcomplete/tar 	pcomplete/time
pcomplete/tlmgr 	pcomplete/umount
pcomplete/which 	pcomplete/xargs
pdb 	pending-delete-mode
perform-replace 	perl-mode
perldb 	phases-of-moon
picture-mode 	pike-mode
ping 	plain-TeX-mode
plain-tex-mode 	play-sound
play-sound-file 	play-sound-internal
plist-get 	plist-member
plist-put 	plstore-delete
plstore-find 	plstore-get-file
plstore-mode 	plstore-open
plstore-put 	plstore-save
po-find-file-coding-system 	po-mode
point 	point-at-bol
point-at-eol 	point-marker
point-max 	point-max-marker
point-min 	point-min-marker
point-to-register 	pong
pop 	pop-global-mark
pop-mark 	pop-tag-mark
pop-to-buffer 	pop-to-buffer-same-window
pop-to-mark-command 	pop3-movemail
popup-menu 	popup-menu-normalize-position
pos-visible-in-window-p 	position-bytes
posix-looking-at 	posix-search-backward
posix-search-forward 	posix-string-match
posn-actual-col-row 	posn-area
posn-at-point 	posn-at-x-y
posn-col-row 	posn-image
posn-object 	posn-object-width-height
posn-object-x-y 	posn-point
posn-set-point 	posn-string
posn-timestamp 	posn-window
posn-x-y 	posnp
post-read-decode-hz 	pp
pp-buffer 	pp-eval-expression
pp-eval-last-sexp 	pp-macroexpand-expression
pp-macroexpand-last-sexp 	pp-to-string
pr-customize 	pr-despool-preview
pr-despool-print 	pr-despool-ps-print
pr-despool-using-ghostscript 	pr-help
pr-interface 	pr-printify-buffer
pr-printify-directory 	pr-printify-region
pr-ps-buffer-preview 	pr-ps-buffer-print
pr-ps-buffer-ps-print 	pr-ps-buffer-using-ghostscript
pr-ps-directory-preview 	pr-ps-directory-print
pr-ps-directory-ps-print 	pr-ps-directory-using-ghostscript
pr-ps-fast-fire 	pr-ps-file-preview
pr-ps-file-print 	pr-ps-file-ps-print
pr-ps-file-up-preview 	pr-ps-file-up-ps-print
pr-ps-file-using-ghostscript 	pr-ps-mode-preview
pr-ps-mode-print 	pr-ps-mode-ps-print
pr-ps-mode-using-ghostscript 	pr-ps-name
pr-ps-region-preview 	pr-ps-region-print
pr-ps-region-ps-print 	pr-ps-region-using-ghostscript
pr-ps-utility 	pr-show-lpr-setup
pr-show-pr-setup 	pr-show-ps-setup
pr-toggle-duplex 	pr-toggle-faces
pr-toggle-file-duplex 	pr-toggle-file-landscape
pr-toggle-file-tumble 	pr-toggle-ghostscript
pr-toggle-header 	pr-toggle-header-frame
pr-toggle-landscape 	pr-toggle-line
pr-toggle-lock 	pr-toggle-mode
pr-toggle-region 	pr-toggle-spool
pr-toggle-tumble 	pr-toggle-upside-down
pr-toggle-zebra 	pr-txt-buffer
pr-txt-directory 	pr-txt-fast-fire
pr-txt-mode 	pr-txt-name
pr-txt-region 	pre-write-encode-hz
preceding-char 	preceding-sexp
prefer-coding-system 	prefix-numeric-value
prepare-abbrev-list-buffer 	prepare-change-group
prepend-to-buffer 	prepend-to-register
prettify-symbols--compose-symbol 	prettify-symbols--make-keywords
prettify-symbols-mode 	prettify-symbols-mode-set-explicitly
previous-buffer 	previous-button
previous-char-property-change 	previous-complete-history-element
previous-completion 	previous-error
previous-error-no-select 	previous-frame
previous-history-element 	previous-line
previous-logical-line 	previous-matching-history-element
previous-multiframe-window 	previous-overlay-change
previous-property-change 	previous-single-char-property-change
previous-single-property-change 	previous-window
primitive-undo 	prin1
prin1-char 	prin1-to-string
princ 	princ-list
print 	print-buffer
print-help-return-message 	print-region
proced 	process-attributes
process-buffer 	process-coding-system
process-command 	process-contact
process-datagram-address 	process-exit-status
process-file 	process-file-shell-command
process-filter 	process-filter-multibyte-p
process-get 	process-id
process-inherit-coding-system-flag 	process-kill-buffer-query-function
process-kill-without-query 	process-lines
process-list 	process-live-p
process-mark 	process-menu-mode
process-menu-visit-buffer 	process-name
process-plist 	process-put
process-query-on-exit-flag 	process-running-child-p
process-send-eof 	process-send-region
process-send-string 	process-sentinel
process-status 	process-tty-name
process-type 	processp
profiler-cpu-log 	profiler-cpu-running-p
profiler-cpu-start 	profiler-cpu-stop
profiler-find-profile 	profiler-find-profile-other-frame
profiler-find-profile-other-window 	profiler-memory-log
profiler-memory-running-p 	profiler-memory-start
profiler-memory-stop 	profiler-start
prog-indent-sexp 	prog-mode
prog1 	prog2
progn 	progress-reporter-do-update
progress-reporter-done 	progress-reporter-force-update
progress-reporter-update 	prolog-mode
prompt-for-change-log-name 	propertize
propertized-buffer-identification 	provide
provide-theme 	prune-directory-list
ps-despool 	ps-extend-face
ps-extend-face-list 	ps-line-lengths
ps-mode 	ps-nb-pages-buffer
ps-nb-pages-region 	ps-print-buffer
ps-print-buffer-with-faces 	ps-print-customize
ps-print-region 	ps-print-region-with-faces
ps-setup 	ps-spool-buffer
ps-spool-buffer-with-faces 	ps-spool-region
ps-spool-region-with-faces 	purecopy
push 	push-button
push-mark 	push-mark-command
put 	put-char-code-property
put-charset-property 	put-image
put-text-property 	put-unicode-property-internal
puthash 	pwd
python-mode 	quail-define-package
quail-define-rules 	quail-defrule
quail-defrule-internal 	quail-install-decode-map
quail-install-map 	quail-set-keyboard-layout
quail-show-keyboard-layout 	quail-title
quail-update-leim-list-file 	quail-use-package
query-font 	query-fontset
query-replace 	query-replace-compile-replacement
query-replace-descr 	query-replace-read-args
query-replace-read-from 	query-replace-read-to
query-replace-regexp 	query-replace-regexp-eval
quick-calc 	quickurl
quickurl-add-url 	quickurl-ask
quickurl-browse-url 	quickurl-browse-url-ask
quickurl-edit-urls 	quickurl-list
quickurl-list-mode 	quietly-read-abbrev-file
quit-process 	quit-restore-window
quit-window 	quit-windows-on
quote 	quoted-insert
quoted-printable-decode-region 	radians-to-degrees
raise-frame 	raise-sexp
random 	rassoc
rassq 	rassq-delete-all
rcirc 	rcirc-connect
rcirc-track-minor-mode 	re-builder
re-search-backward 	re-search-backward-lax-whitespace
re-search-forward 	re-search-forward-lax-whitespace
read 	read--expression
read-abbrev-file 	read-all-face-attributes
read-buffer 	read-buffer-file-coding-system
read-buffer-to-switch 	read-char
read-char-by-name 	read-char-choice
read-char-exclusive 	read-charset
read-coding-system 	read-color
read-command 	read-directory-name
read-envvar-name 	read-event
read-extended-command 	read-face-and-attribute
read-face-attribute 	read-face-font
read-face-name 	read-file-modes
read-file-name 	read-file-name--defaults
read-file-name-default 	read-file-name-internal
read-from-minibuffer 	read-from-string
read-hiragana-string 	read-input
read-input-method-name 	read-kbd-macro
read-key 	read-key-sequence
read-key-sequence-vector 	read-language-name
read-minibuffer 	read-multilingual-string
read-no-blanks-input 	read-non-nil-coding-system
read-number 	read-only-mode
read-passwd 	read-quoted-char
read-regexp 	read-regexp-suggestions
read-shell-command 	read-string
read-variable 	recent-auto-save-p
recent-keys 	recenter
recenter-top-bottom 	recentf-mode
recode-file-name 	recode-region
record-window-buffer 	recover-file
recover-session 	recover-session-finish
recover-this-file 	rectangle-mark-mode
rectangle-number-lines 	recursion-depth
recursive-edit 	redirect-debugging-output
redirect-frame-focus 	redisplay
redisplay--update-region-highlight 	redisplay--update-region-highlights
redraw-display 	redraw-frame
redraw-modeline 	refill-mode
reftex-all-document-files 	reftex-citation
reftex-index-phrases-mode 	reftex-isearch-minor-mode
reftex-mode 	reftex-reset-scanning-information
regexp-builder 	regexp-opt
regexp-opt-charset 	regexp-opt-depth
regexp-opt-group 	regexp-quote
region-active-p 	region-beginning
region-end 	register-ccl-program
register-code-conversion-map 	register-describe-oneline
register-input-method 	register-preview
register-preview-default 	register-read-with-preview
register-swap-out 	register-to-point
registerv--make 	registerv-data
registerv-insert-func 	registerv-jump-func
registerv-make 	registerv-p
registerv-print-func 	reindent-then-newline-and-indent
remember 	remember-clipboard
remember-diary-extract-entries 	remember-notes
remember-other-frame 	remhash
remove 	remove-from-invisibility-spec
remove-function 	remove-hook
remove-images 	remove-list-of-text-properties
remove-overlays 	remove-text-properties
remove-yank-excluded-properties 	remq
rename-auto-save-file 	rename-buffer
rename-file 	rename-uniquely
repeat 	repeat-complex-command
repeat-complex-command--called-interactively-skip
repeat-matching-complex-command 	replace-buffer-in-windows
replace-dehighlight 	replace-eval-replacement
replace-highlight 	replace-loop-through-replacements
replace-match 	replace-match-data
replace-match-maybe-edit 	replace-match-string-symbols
replace-quote 	replace-rectangle
replace-regexp 	replace-regexp-in-string
replace-search 	replace-string
report-emacs-bug 	report-errors
reporter-submit-bug-report 	reposition-window
repunctuate-sentences 	require
reset-language-environment 	reset-this-command-lengths
resize-mini-window-internal 	resize-temp-buffer-window
restore-buffer-modified-p 	resume-tty
reveal-mode 	reverse
reverse-region 	revert-buffer
revert-buffer--default
revert-buffer-insert-file-contents--default-function
revert-buffer-with-coding-system 	rfc2104-hash
rfc822-goto-eoh 	rfn-eshadow-setup-minibuffer
rfn-eshadow-sifn-equal 	rfn-eshadow-update-overlay
rgrep 	right-char
right-word 	ring-p
risky-local-variable-p 	rlogin
rmail 	rmail-input
rmail-mode 	rmail-movemail-variant-p
rmail-output 	rmail-output-as-seen
rmail-output-body-to-file 	rmail-set-remote-password
rng-c-load-schema 	rng-nxml-mode-init
rng-validate-mode 	rng-xsd-compile
robin-define-package 	robin-modify-package
robin-use-package 	rot13
rot13-other-window 	rot13-region
rot13-string 	rotate-yank-pointer
round 	route
rplaca 	rplacd
rsh 	rst-minor-mode
rst-mode 	ruby-mode
ruler-mode 	run-at-time
run-dig 	run-hook-with-args
run-hook-with-args-until-failure 	run-hook-with-args-until-success
run-hook-wrapped 	run-hooks
run-lisp 	run-mode-hooks
run-octave 	run-prolog
run-python 	run-scheme
run-window-configuration-change-hook 	run-window-scroll-functions
run-with-idle-timer 	run-with-timer
rx 	rx-to-string
rzgrep 	safe-date-to-time
safe-length 	safe-local-variable-p
same-class-fast-p 	same-class-p
same-window-p 	sanitize-coding-system-list
save-buffer 	save-buffers-kill-emacs
save-buffers-kill-terminal 	save-current-buffer
save-excursion 	save-match-data
save-restriction 	save-selected-window
save-some-buffers 	save-window-excursion
savehist-mode 	sc-cite-original
scan-buf-move-to-region 	scan-buf-next-region
scan-buf-previous-region 	scan-lists
scan-sexps 	scheme-mode
scroll-all-mode 	scroll-bar-columns
scroll-bar-drag 	scroll-bar-drag-1
scroll-bar-drag-position 	scroll-bar-event-ratio
scroll-bar-maybe-set-window-start 	scroll-bar-mode
scroll-bar-scale 	scroll-bar-scroll-down
scroll-bar-scroll-up 	scroll-bar-set-window-start
scroll-bar-toolkit-scroll 	scroll-down
scroll-down-command 	scroll-down-line
scroll-left 	scroll-lock-mode
scroll-other-window 	scroll-other-window-down
scroll-right 	scroll-up
scroll-up-command 	scroll-up-line
sdb 	search-backward
search-backward-lax-whitespace 	search-backward-regexp
search-emacs-glossary 	search-forward
search-forward-lax-whitespace 	search-forward-regexp
search-unencodable-char 	seconds-to-time
secrets-create-item 	secrets-delete-item
secrets-get-alias 	secrets-get-attributes
secrets-get-secret 	secrets-list-collections
secrets-search-items 	secrets-show-secrets
secure-hash 	select-frame
select-frame-by-name 	select-frame-set-input-focus
select-message-coding-system 	select-safe-coding-system
select-safe-coding-system-interactively 	select-tags-table
select-window 	selected-frame
selected-window 	self-insert-and-exit
self-insert-command 	semantic-mode
send-region 	send-string
send-string-to-terminal 	sendmail-query-once
sendmail-user-agent-compose 	sentence-end
sequencep 	serial-process-configure
serial-term 	server-force-delete
server-mode 	server-save-buffers-kill-terminal
server-start 	ses-mode
set 	set-advertised-calling-convention
set-auto-coding 	set-auto-mode
set-auto-mode-0 	set-auto-mode-1
set-background-color 	set-border-color
set-buffer 	set-buffer-auto-saved
set-buffer-file-coding-system 	set-buffer-major-mode
set-buffer-modified-p 	set-buffer-multibyte
set-buffer-process-coding-system 	set-case-syntax
set-case-syntax-delims 	set-case-syntax-pair
set-case-table 	set-category-table
set-char-table-extra-slot 	set-char-table-parent
set-char-table-range 	set-charset-plist
set-charset-priority 	set-clipboard-coding-system
set-coding-priority 	set-coding-system-priority
set-comment-column 	set-cursor-color
set-default 	set-default-coding-systems
set-default-file-modes 	set-default-font
set-default-toplevel-value
set-display-table-and-terminal-coding-system
set-display-table-slot 	set-downcase-syntax
set-face-attribute 	set-face-attribute-from-resource
set-face-attributes-from-resources 	set-face-background
set-face-background-pixmap 	set-face-bold
set-face-bold-p 	set-face-doc-string
set-face-documentation 	set-face-font
set-face-foreground 	set-face-inverse-video
set-face-inverse-video-p 	set-face-italic
set-face-italic-p 	set-face-stipple
set-face-underline 	set-face-underline-p
set-file-acl 	set-file-extended-attributes
set-file-modes 	set-file-name-coding-system
set-file-selinux-context 	set-file-times
set-fill-column 	set-fill-prefix
set-font-encoding 	set-fontset-font
set-foreground-color 	set-frame-configuration
set-frame-font 	set-frame-height
set-frame-name 	set-frame-parameter
set-frame-position 	set-frame-selected-window
set-frame-size 	set-frame-width
set-fringe-bitmap-face 	set-fringe-mode
set-fringe-mode-1 	set-fringe-style
set-goal-column 	set-hard-newline-properties
set-input-interrupt-mode 	set-input-meta-mode
set-input-method 	set-input-mode
set-justification 	set-justification-center
set-justification-full 	set-justification-left
set-justification-none 	set-justification-right
set-keyboard-coding-system 	set-keyboard-coding-system-internal
set-keymap-parent 	set-language-environment
set-language-environment-charset 	set-language-environment-coding-systems
set-language-environment-input-method
set-language-environment-nonascii-translation
set-language-environment-unibyte 	set-language-info
set-language-info-alist 	set-language-info-internal
set-left-margin 	set-locale-environment
set-mark 	set-mark-command
set-marker 	set-marker-insertion-type
set-match-data 	set-minibuffer-window
set-mouse-color 	set-mouse-pixel-position
set-mouse-position 	set-nested-alist
set-network-process-option 	set-next-selection-coding-system
set-output-flow-control 	set-process-buffer
set-process-coding-system 	set-process-datagram-address
set-process-filter 	set-process-filter-multibyte
set-process-inherit-coding-system-flag 	set-process-plist
set-process-query-on-exit-flag 	set-process-sentinel
set-process-window-size 	set-quit-char
set-register 	set-right-margin
set-safe-terminal-coding-system-internal
set-scroll-bar-mode 	set-selection-coding-system
set-selective-display 	set-slot-value
set-standard-case-table 	set-syntax-table
set-temporary-overlay-map 	set-terminal-coding-system
set-terminal-coding-system-internal 	set-terminal-parameter
set-text-properties 	set-time-zone-rule
set-transient-map 	set-upcase-syntax
set-variable 	set-visited-file-modtime
set-visited-file-name 	set-window-buffer
set-window-buffer-start-and-point 	set-window-combination-limit
set-window-configuration 	set-window-dedicated-p
set-window-display-table 	set-window-dot
set-window-fringes 	set-window-hscroll
set-window-margins 	set-window-new-normal
set-window-new-pixel 	set-window-new-total
set-window-next-buffers 	set-window-parameter
set-window-point 	set-window-prev-buffers
set-window-redisplay-end-trigger 	set-window-scroll-bars
set-window-start 	set-window-text-height
set-window-vscroll 	setcar
setcdr 	setenv
setenv-internal 	setf
setplist 	setq
setq-default 	setq-local
setup-chinese-environment-map 	setup-cyrillic-environment-map
setup-default-fontset 	setup-ethiopic-environment-internal
setup-european-environment-map 	setup-indian-environment-map
setup-japanese-environment-internal 	setup-korean-environment-internal
setup-specified-language-environment 	sexp-at-point
sgml-html-meta-auto-coding-function 	sgml-mode
sgml-xml-auto-coding-function 	sh-mode
sha1 	shadow-define-cluster
shadow-define-literal-group 	shadow-define-regexp-group
shadow-initialize 	shared-initialize
shell 	shell-command
shell-command-on-region 	shell-command-sentinel
shell-command-to-string 	shell-quote-argument
shell-quote-wildcard-pattern 	shell-script-mode
show-buffer 	show-paren-mode
shr-insert-document 	shr-render-region
shrink-window 	shrink-window-horizontally
shrink-window-if-larger-than-buffer 	sieve-manage
sieve-mode 	sieve-upload
sieve-upload-and-bury 	sieve-upload-and-kill
signal 	signal-process
simula-mode 	sin
single-key-description 	sit-for
size-indication-mode 	skeleton-insert
skeleton-pair-insert-maybe 	skeleton-proxy-new
skip-chars-backward 	skip-chars-forward
skip-line-prefix 	skip-syntax-backward
skip-syntax-forward 	sleep-for
slitex-mode 	slot-boundp
slot-exists-p 	slot-makeunbound
slot-missing 	slot-unbound
slot-value 	smerge-ediff
smerge-mode 	smerge-start-session
smiley-buffer 	smiley-region
smtpmail-send-it 	smtpmail-send-queued-mail
snake 	snarf-spooks
snmp-mode 	snmpv2-mode
solitaire 	some-window
sort 	sort-charsets
sort-coding-systems 	sort-columns
sort-fields 	sort-lines
sort-numeric-fields 	sort-pages
sort-paragraphs 	sort-regexp-fields
sort-subr 	spam-initialize
spam-report-agentize 	spam-report-deagentize
spam-report-process-queue 	spam-report-url-ping-mm-url
spam-report-url-to-file 	special-display-p
special-display-popup-frame 	special-form-p
special-mode 	special-variable-p
speedbar 	speedbar-frame-mode
speedbar-get-focus 	split-char
split-line 	split-string
split-string-and-unquote 	split-window
split-window-below 	split-window-horizontally
split-window-internal 	split-window-right
split-window-sensibly 	split-window-vertically
spook 	sql-add-product-keywords
sql-connect 	sql-db2
sql-informix 	sql-ingres
sql-interbase 	sql-linter
sql-mode 	sql-ms
sql-mysql 	sql-oracle
sql-postgres 	sql-product-interactive
sql-solid 	sql-sqlite
sql-sybase 	sqrt
srecode-template-mode 	srt-mode
standard-case-table 	standard-category-table
standard-class 	standard-display-8bit
standard-display-ascii 	standard-display-cyrillic-translit
standard-display-default 	standard-display-european
standard-display-european-internal 	standard-display-g1
standard-display-graphic 	standard-display-underline
standard-syntax-table 	start-file-process
start-file-process-shell-command 	start-kbd-macro
start-of-paragraph-text 	start-process
start-process-shell-command 	starttls-open-stream
startup-echo-area-message 	stop-process
store-kbd-macro-event 	store-match-data
store-substring 	string
string-as-multibyte 	string-as-unibyte
string-bytes 	string-equal
string-insert-rectangle 	string-lessp
string-make-multibyte 	string-make-unibyte
string-match 	string-match-p
string-or-null-p 	string-prefix-p
string-rectangle 	string-suffix-p
string-to-char 	string-to-int
string-to-list 	string-to-multibyte
string-to-number 	string-to-syntax
string-to-unibyte 	string-to-vector
string-width 	string<
string= 	stringp
strokes-compose-complex-stroke 	strokes-decode-buffer
strokes-describe-stroke 	strokes-do-complex-stroke
strokes-do-stroke 	strokes-global-set-stroke
strokes-help 	strokes-list-strokes
strokes-load-user-strokes 	strokes-mode
strokes-read-complex-stroke 	strokes-read-stroke
studlify-buffer 	studlify-region
studlify-word 	subr-arity
subr-name 	subregexp-context-p
subrp 	subst-char-in-region
subst-char-in-string 	substitute-command-keys
substitute-env-in-file-name 	substitute-env-vars
substitute-in-file-name 	substitute-key-definition
substitute-key-definition-key 	substring
substring-no-properties 	subtract-time
subword-mode 	sunrise-sunset
superword-mode 	suppress-keymap
suspend-emacs 	suspend-frame
suspend-tty 	switch-to-buffer
switch-to-buffer-other-frame 	switch-to-buffer-other-window
switch-to-completions 	switch-to-next-buffer
switch-to-prev-buffer 	sxhash
symbol-at-point 	symbol-file
symbol-function 	symbol-name
symbol-plist 	symbol-value
symbolp 	syntax-after
syntax-class 	syntax-ppss
syntax-ppss-after-change-function 	syntax-ppss-context
syntax-ppss-debug 	syntax-ppss-depth
syntax-ppss-flush-cache 	syntax-ppss-stats
syntax-ppss-toplevel-pos 	syntax-propertize
syntax-propertize--shift-groups 	syntax-propertize-multiline
syntax-propertize-precompile-rules 	syntax-propertize-rules
syntax-propertize-via-font-lock 	syntax-propertize-wholelines
syntax-table 	syntax-table-p
system-groups 	system-name
system-users 	t-mouse-mode
tab-to-tab-stop 	tabify
table-backward-cell 	table-capture
table-delete-column 	table-delete-row
table-fixed-width-mode 	table-forward-cell
table-generate-source 	table-heighten-cell
table-insert 	table-insert-column
table-insert-row 	table-insert-row-column
table-insert-sequence 	table-justify
table-justify-cell 	table-justify-column
table-justify-row 	table-narrow-cell
table-query-dimension 	table-recognize
table-recognize-cell 	table-recognize-region
table-recognize-table 	table-release
table-shorten-cell 	table-span-cell
table-split-cell 	table-split-cell-horizontally
table-split-cell-vertically 	table-unrecognize
table-unrecognize-cell 	table-unrecognize-region
table-unrecognize-table 	table-widen-cell
tabulated-list--column-number 	tabulated-list--sort-by-column-name
tabulated-list-col-sort 	tabulated-list-delete-entry
tabulated-list-entry-size-> 	tabulated-list-get-entry
tabulated-list-get-id 	tabulated-list-init-header
tabulated-list-mode 	tabulated-list-print
tabulated-list-print-col 	tabulated-list-print-entry
tabulated-list-print-fake-header 	tabulated-list-put-tag
tabulated-list-revert 	tabulated-list-set-col
tabulated-list-sort 	tags-apropos
tags-completion-at-point-function 	tags-loop-continue
tags-query-replace 	tags-search
tags-table-files 	tags-table-mode
tai-viet-composition-function 	talk
talk-connect 	tan
tar-mode 	tcl-help-on-word
tcl-mode 	telnet
temp-buffer-resize-mode 	temp-buffer-window-setup
temp-buffer-window-show 	term
terminal-coding-system 	terminal-list
terminal-live-p 	terminal-name
terminal-parameter 	terminal-parameters
terpri 	test-completion
testcover-this-defun 	tetris
tex-mode 	tex-start-shell
texi2info 	texinfo-format-buffer
texinfo-format-region 	texinfo-mode
text-char-description 	text-clone--maintain
text-clone-create 	text-mode
text-mode-hook-identify 	text-properties-at
text-property-any 	text-property-not-all
text-scale-adjust 	text-scale-decrease
text-scale-increase 	text-scale-set
thai-compose-buffer 	thai-compose-region
thai-compose-string 	thai-composition-function
thing-at-point 	this-command-keys
this-command-keys-vector 	this-single-command-keys
this-single-command-raw-keys 	throw
thumbs 	thumbs-dired-setroot
thumbs-dired-show 	thumbs-dired-show-marked
thumbs-find-thumb 	thumbs-show-from-dir
tibetan-char-p 	tibetan-compose-buffer
tibetan-compose-region 	tibetan-compose-string
tibetan-decompose-buffer 	tibetan-decompose-region
tibetan-decompose-string 	tibetan-post-read-conversion
tibetan-pre-write-canonicalize-for-unicode
tibetan-pre-write-conversion 	tibetan-tibetan-to-transcription
tibetan-transcription-to-tibetan 	tildify-buffer
tildify-region 	time-add
time-less-p 	time-since
time-stamp 	time-stamp-toggle-active
time-subtract 	time-to-day-in-year
time-to-days 	time-to-number-of-days
time-to-seconds 	timeclock-change
timeclock-in 	timeclock-mode-line-display
timeclock-out 	timeclock-query-out
timeclock-reread-log 	timeclock-status-string
timeclock-when-to-leave-string 	timeclock-workday-elapsed-string
timeclock-workday-remaining-string 	timeout-event-p
timer--activate 	timer--args
timer--check 	timer--function
timer--high-seconds 	timer--idle-delay
timer--low-seconds 	timer--psecs
timer--repeat-delay 	timer--time
timer--time-less-p 	timer--time-setter
timer--triggered 	timer--usecs
timer-activate 	timer-activate-when-idle
timer-create 	timer-duration
timer-event-handler 	timer-inc-time
timer-next-integral-multiple-of-time 	timer-relative-time
timer-set-function 	timer-set-idle-time
timer-set-time 	timer-set-time-with-usecs
timer-until 	timerp
timezone-make-date-arpa-standard 	timezone-parse-date
titdic-convert 	tmm-menubar
tmm-menubar-mouse 	tmm-prompt
todo-archive-mode 	todo-filtered-items-mode
todo-mode 	todo-show
toggle-auto-composition 	toggle-case-fold-search
toggle-debug-on-error 	toggle-debug-on-quit
toggle-enable-multibyte-characters 	toggle-frame-fullscreen
toggle-frame-maximized 	toggle-horizontal-scroll-bar
toggle-indicate-empty-lines 	toggle-input-method
toggle-menu-bar-mode-from-frame 	toggle-read-only
toggle-rot13-mode 	toggle-save-place-globally
toggle-scroll-bar 	toggle-text-mode-auto-fill
toggle-tool-bar-mode-from-frame 	toggle-truncate-lines
toggle-uniquify-buffer-names 	toggle-use-system-font
toggle-viper-mode 	toggle-word-wrap
tool-bar--image-expression 	tool-bar-add-item
tool-bar-add-item-from-menu 	tool-bar-get-system-style
tool-bar-height 	tool-bar-lines-needed
tool-bar-local-item 	tool-bar-local-item-from-menu
tool-bar-make-keymap 	tool-bar-make-keymap-1
tool-bar-mode 	tool-bar-pixel-width
tool-bar-setup 	tooltip-cancel-delayed-tip
tooltip-delay 	tooltip-event-buffer
tooltip-expr-to-print 	tooltip-help-tips
tooltip-hide 	tooltip-identifier-from-point
tooltip-mode 	tooltip-process-prompt-regexp
tooltip-region-active-p 	tooltip-set-param
tooltip-show 	tooltip-show-help
tooltip-show-help-non-mode 	tooltip-start-delayed-tip
tooltip-strip-prompt 	tooltip-timeout
top-level 	tq-create
trace-function 	trace-function-background
trace-function-foreground 	trace-values
traceroute 	track-mouse
tramp-autoload-file-name-handler 	tramp-completion-file-name-handler
tramp-completion-handle-file-name-all-completions
tramp-completion-handle-file-name-completion
tramp-completion-run-real-handler 	tramp-ftp-enable-ange-ftp
tramp-register-autoload-file-name-handlers
tramp-unload-file-name-handlers 	tramp-unload-tramp
transform-make-coding-system-args 	transient-mark-mode
translate-region 	translate-region-internal
transpose-chars 	transpose-lines
transpose-paragraphs 	transpose-regions
transpose-sentences 	transpose-sexps
transpose-subr 	transpose-subr-1
transpose-words 	truncate
truncate-string-to-width 	truncated-partial-width-window-p
try-completion 	tty-color-alist
tty-color-approximate 	tty-color-by-index
tty-color-canonicalize 	tty-color-clear
tty-color-define 	tty-color-desc
tty-color-gray-shades 	tty-color-off-gray-diag
tty-color-standard-values 	tty-color-translate
tty-color-values 	tty-create-frame-with-faces
tty-display-color-cells 	tty-display-color-p
tty-find-type 	tty-handle-args
tty-handle-reverse-video 	tty-modify-color-alist
tty-no-underline 	tty-register-default-colors
tty-run-terminal-initialization 	tty-set-up-initial-frame-faces
tty-suppress-bold-inverse-default-colors
tty-top-frame 	tty-type
tumme 	turkish-case-conversion-disable
turkish-case-conversion-enable 	turn-off-auto-fill
turn-off-flyspell 	turn-off-follow-mode
turn-off-hideshow 	turn-on-auto-fill
turn-on-auto-revert-mode 	turn-on-auto-revert-tail-mode
turn-on-cwarn-mode 	turn-on-eldoc-mode
turn-on-flyspell 	turn-on-follow-mode
turn-on-font-lock 	turn-on-font-lock-if-desired
turn-on-gnus-dired-mode 	turn-on-gnus-mailing-list-mode
turn-on-iimage-mode 	turn-on-orgstruct
turn-on-orgstruct++ 	turn-on-orgtbl
turn-on-prettify-symbols-mode 	turn-on-reftex
turn-on-visual-line-mode 	type-break
type-break-guesstimate-keystroke-threshold
type-break-mode 	type-break-statistics
type-of 	uce-reply-to-uce
ucs-input-activate 	ucs-insert
ucs-names 	ucs-normalize-HFS-NFC-region
ucs-normalize-HFS-NFC-string 	ucs-normalize-HFS-NFD-region
ucs-normalize-HFS-NFD-string 	ucs-normalize-NFC-region
ucs-normalize-NFC-string 	ucs-normalize-NFD-region
ucs-normalize-NFD-string 	ucs-normalize-NFKC-region
ucs-normalize-NFKC-string 	ucs-normalize-NFKD-region
ucs-normalize-NFKD-string 	unbury-buffer
uncomment-region 	uncomment-region-default
undefined 	underline-region
undo 	undo-boundary
undo-copy-list 	undo-copy-list-1
undo-delta 	undo-elt-crosses-region
undo-elt-in-region 	undo-make-selective-list
undo-more 	undo-only
undo-outer-limit-truncate 	undo-start
unencodable-char-position 	unexpand-abbrev
unfocus-frame 	unhandled-file-name-directory
unhighlight-regexp 	unibyte-char-to-multibyte
unibyte-string 	unicode-property-table-internal
unify-8859-on-decoding-mode 	unify-8859-on-encoding-mode
unify-charset 	unintern
uniquify--create-file-buffer-advice 	uniquify--rename-buffer-advice
uniquify-buffer-base-name 	uniquify-buffer-file-name
uniquify-get-proposed-name 	uniquify-item-base
uniquify-item-buffer 	uniquify-item-dirname
uniquify-item-greaterp 	uniquify-item-p
uniquify-item-proposed 	uniquify-kill-buffer-function
uniquify-make-item 	uniquify-maybe-rerationalize-w/o-cb
uniquify-rationalize 	uniquify-rationalize-a-list
uniquify-rationalize-conflicting-sublist
uniquify-rationalize-file-buffer-names 	uniquify-rename-buffer
uniquify-rerationalize-w/o-cb 	uniquify-unload-function
universal-argument 	universal-argument--mode
universal-argument-more 	universal-coding-system-argument
unix-sync 	unjustify-current-line
unjustify-region 	unless
unload-feature 	unlock-buffer
unmorse-region 	unmsys--file-name
unrecord-window-buffer 	unrmail
unsafep 	untabify
ununderline-region 	unwind-protect
up-list 	upcase
upcase-initials 	upcase-initials-region
upcase-region 	upcase-word
update-directory-autoloads 	update-file-autoloads
update-glyphless-char-display 	update-leim-list-file
url--allowed-chars 	url-attributes
url-basepath 	url-bit-for-url
url-build-query-string 	url-cache-extract
url-cache-prune-cache 	url-cid
url-completion-function 	url-cookie-clean-up
url-cookie-create 	url-cookie-delete
url-cookie-domain 	url-cookie-expired-p
url-cookie-expires 	url-cookie-generate-header-lines
url-cookie-handle-set-cookie 	url-cookie-host-can-set-p
url-cookie-list 	url-cookie-localpart
url-cookie-mode 	url-cookie-name
url-cookie-p 	url-cookie-parse-file
url-cookie-quit 	url-cookie-retrieve
url-cookie-secure 	url-cookie-setup-save-timer
url-cookie-store 	url-cookie-value
url-cookie-write-file 	url-copy-file
url-data 	url-dav-request
url-dav-supported-p 	url-dav-vc-registered
url-debug 	url-default-expander
url-default-find-proxy-for-url 	url-device-type
url-display-percentage 	url-do-setup
url-domsuf-cookie-allowed-p 	url-domsuf-parse-file
url-eat-trailing-space 	url-encode-url
url-expand-file-name 	url-expander-remove-relative-links
url-extract-mime-headers 	url-file
url-file-directory 	url-file-extension
url-file-handler 	url-file-local-copy
url-file-nondirectory 	url-filename
url-find-proxy-for-url 	url-fullness
url-gateway-nslookup-host 	url-gc-dead-buffers
url-generate-unique-filename 	url-generic-emulator-loader
url-generic-parse-url 	url-get-authentication
url-get-normalized-date 	url-get-url-at-point
url-handler-mode 	url-have-visited-url
url-hexify-string 	url-history-parse-history
url-history-save-history 	url-history-setup-save-timer
url-history-update-url 	url-host
url-http 	url-https
url-https-expand-file-name 	url-https-file-attributes
url-https-file-exists-p 	url-https-file-readable-p
url-identity-expander 	url-info
url-insert-entities-in-string 	url-insert-file-contents
url-irc 	url-is-cached
url-lazy-message 	url-ldap
url-mail 	url-mailto
url-make-private-file 	url-man
url-mark-buffer-as-dead 	url-mime-charset-string
url-mm-callback 	url-mm-url
url-news 	url-normalize-url
url-ns-prefs 	url-ns-user-pref
url-open-stream 	url-p
url-parse-args 	url-parse-make-urlobj
url-parse-query-string 	url-password
url-password-for-url 	url-path-and-query
url-percentage 	url-port
url-port-if-non-default 	url-portspec
url-pretty-length 	url-proxy
url-queue-retrieve 	url-recreate-url
url-recreate-url-attributes 	url-register-auth-scheme
url-retrieve 	url-retrieve-internal
url-retrieve-synchronously 	url-rlogin
url-scheme-default-loader 	url-scheme-get-property
url-scheme-register-proxy 	url-set-mime-charset-string
url-setup-privacy-info 	url-silent
url-snews 	url-store-in-cache
url-strip-leading-spaces 	url-target
url-telnet 	url-tn3270
url-truncate-url-for-viewing 	url-type
url-unhex 	url-unhex-string
url-use-cookies 	url-user
url-user-for-url 	url-view-url
url-warn 	use-cjk-char-width-table
use-default-char-width-table 	use-fancy-splash-screens-p
use-global-map 	use-hard-newlines
use-local-map 	use-region-p
user-error 	user-full-name
user-login-name 	user-original-login-name
user-real-login-name 	user-real-uid
user-uid 	user-variable-p
utf-7-imap-post-read-conversion 	utf-7-imap-pre-write-conversion
utf-7-post-read-conversion 	utf-7-pre-write-conversion
utf7-encode 	uudecode-decode-region
uudecode-decode-region-external 	uudecode-decode-region-internal
variable-at-point 	variable-binding-locus
variable-pitch-mode 	vc-after-save
vc-annotate 	vc-arch-registered
vc-backend 	vc-backend-subdirectory-name
vc-before-save 	vc-branch-part
vc-bzr-registered 	vc-call
vc-call-backend 	vc-check-master-templates
vc-checkout-model 	vc-create-tag
vc-cvs-registered 	vc-default-extra-menu
vc-default-find-file-hook 	vc-default-make-version-backups-p
vc-default-mode-line-string 	vc-default-registered
vc-default-state-heuristic 	vc-default-workfile-unchanged-p
vc-default-working-revision 	vc-delete-automatic-version-backups
vc-delete-file 	vc-diff
vc-dir 	vc-do-command
vc-ediff 	vc-error-occurred
vc-file-clearprops 	vc-file-getprop
vc-file-setprop 	vc-find-backend-function
vc-find-file-hook 	vc-find-root
vc-follow-link 	vc-git--call
vc-git--empty-db-p 	vc-git--out-ok
vc-git--rev-parse 	vc-git--run-command-string
vc-git--state-code 	vc-git-after-dir-status-stage
vc-git-annotate-command 	vc-git-annotate-extract-revision-at-line
vc-git-annotate-time 	vc-git-branches
vc-git-checkin 	vc-git-checkout
vc-git-checkout-model 	vc-git-command
vc-git-create-extra-fileinfo 	vc-git-create-repo
vc-git-create-tag 	vc-git-delete-file
vc-git-diff 	vc-git-dir-extra-headers
vc-git-dir-printer 	vc-git-dir-status
vc-git-dir-status-files 	vc-git-dir-status-goto-stage
vc-git-escape-file-name 	vc-git-expanded-log-entry
vc-git-extra-fileinfo->new-perm 	vc-git-extra-fileinfo->old-perm
vc-git-extra-fileinfo->orig-name 	vc-git-extra-fileinfo->rename-state
vc-git-extra-fileinfo-p 	vc-git-extra-menu
vc-git-extra-status-menu 	vc-git-file-type-as-string
vc-git-find-ignore-file 	vc-git-find-revision
vc-git-grep 	vc-git-log-edit-mode
vc-git-log-edit-toggle-amend 	vc-git-log-edit-toggle-signoff
vc-git-log-incoming 	vc-git-log-outgoing
vc-git-log-view-mode 	vc-git-merge-branch
vc-git-mode-line-string 	vc-git-next-revision
vc-git-permissions-as-string 	vc-git-previous-revision
vc-git-print-log 	vc-git-pull
vc-git-register 	vc-git-registered
vc-git-rename-as-string 	vc-git-rename-file
vc-git-responsible-p 	vc-git-retrieve-tag
vc-git-revert 	vc-git-revision-completion-table
vc-git-revision-granularity 	vc-git-revision-table
vc-git-root 	vc-git-show-log-entry
vc-git-stash 	vc-git-stash-apply
vc-git-stash-apply-at-point 	vc-git-stash-delete-at-point
vc-git-stash-get-at-point 	vc-git-stash-list
vc-git-stash-menu 	vc-git-stash-pop
vc-git-stash-pop-at-point 	vc-git-stash-show
vc-git-stash-show-at-point 	vc-git-stash-snapshot
vc-git-state 	vc-git-symbolic-commit
vc-git-unregister 	vc-git-workfile-unchanged-p
vc-git-working-revision 	vc-hg-registered
vc-insert-file 	vc-insert-headers
vc-kill-buffer-hook 	vc-log-incoming
vc-log-outgoing 	vc-make-backend-sym
vc-make-version-backup 	vc-menu-map
vc-menu-map-filter 	vc-merge
vc-mistrust-permissions 	vc-mode
vc-mode-line 	vc-mtn-registered
vc-name 	vc-next-action
vc-parse-buffer 	vc-possible-master
vc-prefix-map 	vc-print-log
vc-print-root-log 	vc-pull
vc-rcs-registered 	vc-register
vc-registered 	vc-rename-file
vc-resolve-conflicts 	vc-resynch-buffer
vc-retrieve-tag 	vc-revert
vc-revert-buffer 	vc-revision-other-window
vc-rollback 	vc-root-diff
vc-sccs-registered 	vc-sccs-search-project-dir
vc-setup-buffer 	vc-state
vc-state-refresh 	vc-stay-local-p
vc-svn-registered 	vc-switch-backend
vc-switches 	vc-toggle-read-only
vc-transfer-file 	vc-up-to-date-p
vc-update 	vc-update-change-log
vc-user-login-name 	vc-version-backup-file-name
vc-version-diff 	vc-version-ediff
vc-workfile-unchanged-p 	vc-workfile-version
vc-working-revision 	vconcat
vector 	vector-or-char-table-p
vectorp 	vendor-specific-keysyms
vera-mode 	verify-visited-file-modtime
verilog-mode 	version
version-list-< 	version-list-<=
version-list-= 	version-list-not-zero
version-to-list 	version<
version<= 	version=
vertical-motion 	vhdl-mode
viet-decode-viqr-buffer 	viet-decode-viqr-region
viet-encode-viqr-buffer 	viet-encode-viqr-region
viet-encode-viscii-char 	view-buffer
view-buffer-other-frame 	view-buffer-other-window
view-echo-area-messages 	view-emacs-FAQ
view-emacs-debugging 	view-emacs-news
view-emacs-problems 	view-emacs-todo
view-external-packages 	view-file
view-file-other-frame 	view-file-other-window
view-hello-file 	view-help-file
view-lossage 	view-mode
view-mode-enter 	view-order-manuals
view-register 	view-return-to-alist-update
view-todo 	viper-mode
viqr-post-read-conversion 	viqr-pre-write-conversion
visible-frame-list 	visible-mode
visit-tags-table 	visit-tags-table-buffer
visited-file-modtime 	visual-line-mode
visual-line-mode-set-explicitly 	waiting-for-user-input-p
walk-window-subtree 	walk-window-tree
walk-window-tree-1 	walk-windows
warn 	wdired-change-to-wdired-mode
webjump 	what-cursor-position
what-domain 	what-line
what-page 	when
where-is 	where-is-internal
which-func-mode 	which-function-mode
while 	while-no-input
whitespace-cleanup 	whitespace-cleanup-region
whitespace-mode 	whitespace-newline-mode
whitespace-report 	whitespace-report-region
whitespace-toggle-options 	whois
whois-reverse-lookup 	wholenump
widen 	widget-apply
widget-browse 	widget-browse-at
widget-browse-other-window 	widget-create
widget-delete 	widget-get
widget-insert 	widget-minor-mode
widget-plist-member 	widget-prompt-value
widget-put 	widget-setup
widget-value 	widgetp
wildcard-to-regexp 	windmove-default-keybindings
windmove-down 	windmove-left
windmove-right 	windmove-up
window--atom-check 	window--atom-check-1
window--check 	window--delete
window--display-buffer 	window--dump-frame
window--dump-window 	window--even-window-heights
window--frame-usable-p 	window--in-direction-2
window--in-subtree-p 	window--major-non-side-window
window--major-side-window 	window--max-delta-1
window--maybe-raise-frame 	window--min-delta-1
window--min-size-1 	window--pixel-to-total
window--pixel-to-total-1 	window--resizable
window--resizable-p 	window--resize-apply-p
window--resize-child-windows 	window--resize-child-windows-normal
window--resize-child-windows-skip-p 	window--resize-mini-window
window--resize-reset 	window--resize-reset-1
window--resize-root-window 	window--resize-root-window-vertically
window--resize-siblings 	window--resize-this-window
window--sanitize-margin 	window--side-check
window--size-fixed-1 	window--size-ignore-p
window--size-to-pixel 	window--state-get-1
window--state-put-1 	window--state-put-2
window--subtree 	window--try-to-split-window
window-absolute-pixel-edges 	window-at
window-at-side-list 	window-at-side-p
window-atom-root 	window-body-height
window-body-size 	window-body-width
window-bottom-divider-width 	window-buffer
window-buffer-height 	window-child
window-child-count 	window-combination-limit
window-combination-p 	window-combinations
window-combined-p 	window-configuration-frame
window-configuration-p 	window-configuration-to-register
window-current-scroll-bars 	window-dedicated-p
window-deletable-p 	window-display-table
window-dot 	window-edges
window-end 	window-fixed-size-p
window-frame 	window-fringes
window-full-height-p 	window-full-width-p
window-header-line-height 	window-height
window-hscroll 	window-in-direction
window-inside-absolute-pixel-edges 	window-inside-edges
window-inside-pixel-edges 	window-last-child
window-left 	window-left-child
window-left-column 	window-line-height
window-list 	window-list-1
window-live-p 	window-make-atom
window-margins 	window-max-delta
window-min-delta 	window-min-pixel-height
window-min-pixel-width 	window-min-size
window-minibuffer-p 	window-mode-line-height
window-new-normal 	window-new-pixel
window-new-total 	window-next-buffers
window-next-sibling 	window-normal-size
window-normalize-buffer 	window-normalize-buffer-to-switch-to
window-normalize-frame 	window-normalize-window
window-parameter 	window-parameters
window-parent 	window-pixel-edges
window-pixel-height 	window-pixel-left
window-pixel-top 	window-pixel-width
window-point 	window-prev-buffers
window-prev-sibling 	window-redisplay-end-trigger
window-resizable 	window-resizable-p
window-resize 	window-resize-apply
window-resize-apply-total 	window-resize-no-error
window-right 	window-right-divider-width
window-safe-min-pixel-height 	window-safe-min-pixel-size
window-safe-min-pixel-width 	window-safe-min-size
window-safely-shrinkable-p 	window-screen-lines
window-scroll-bar-width 	window-scroll-bars
window-sizable 	window-sizable-p
window-size 	window-size-fixed-p
window-split-min-size 	window-splittable-p
window-start 	window-state-get
window-state-put 	window-system
window-system-for-display 	window-text-height
window-text-pixel-size 	window-text-width
window-top-child 	window-top-line
window-total-height 	window-total-size
window-total-width 	window-tree
window-use-time 	window-valid-p
window-vscroll 	window-width
window-with-parameter 	windowp
winner-mode 	wisent-grammar-mode
with-auto-compression-mode 	with-case-table
with-category-table 	with-coding-priority
with-current-buffer 	with-current-buffer-window
with-decoded-time-value 	with-demoted-errors
with-electric-help 	with-eval-after-load
with-help-window 	with-isearch-suspended
with-local-quit 	with-no-warnings
with-output-to-string 	with-output-to-temp-buffer
with-selected-frame 	with-selected-window
with-silent-modifications 	with-slots
with-syntax-table 	with-temp-buffer
with-temp-buffer-window 	with-temp-file
with-temp-message 	with-timeout
with-timeout-suspend 	with-timeout-unsuspend
with-wrapper-hook 	woman
woman-bookmark-jump 	woman-dired-find-file
woman-find-file 	word-search-backward
word-search-backward-lax 	word-search-forward
word-search-forward-lax 	word-search-regexp
write-abbrev-file 	write-char
write-file 	write-region
x-apply-session-resources 	x-backspace-delete-keys-p
x-change-window-property 	x-clipboard-yank
x-close-connection 	x-color-defined-p
x-color-values 	x-complement-fontset-spec
x-compose-font-name 	x-create-frame
x-create-frame-with-faces 	x-cut-buffer-or-selection-value
x-decompose-font-name 	x-defined-colors
x-delete-window-property 	x-disown-selection-internal
x-display-backing-store 	x-display-color-cells
x-display-color-p 	x-display-grayscale-p
x-display-list 	x-display-mm-height
x-display-mm-width 	x-display-monitor-attributes-list
x-display-pixel-height 	x-display-pixel-width
x-display-planes 	x-display-save-under
x-display-screens 	x-display-visual-class
x-dnd-choose-type 	x-dnd-current-type
x-dnd-default-test-function 	x-dnd-drop-data
x-dnd-forget-drop 	x-dnd-get-drop-width-height
x-dnd-get-drop-x-y 	x-dnd-get-motif-value
x-dnd-get-state-cons-for-frame 	x-dnd-get-state-for-frame
x-dnd-handle-drag-n-drop-event 	x-dnd-handle-file-name
x-dnd-handle-motif 	x-dnd-handle-moz-url
x-dnd-handle-old-kde 	x-dnd-handle-uri-list
x-dnd-handle-xdnd 	x-dnd-init-frame
x-dnd-init-motif-for-frame 	x-dnd-init-xdnd-for-frame
x-dnd-insert-ctext 	x-dnd-insert-utf16-text
x-dnd-insert-utf8-text 	x-dnd-maybe-call-test-function
x-dnd-more-than-3-from-flags 	x-dnd-motif-value-to-list
x-dnd-save-state 	x-dnd-version-from-flags
x-family-fonts 	x-file-dialog
x-focus-frame 	x-get-atom-name
x-get-clipboard 	x-get-resource
x-get-selection 	x-get-selection-internal
x-get-selection-value 	x-gtk-map-stock
x-handle-args 	x-handle-display
x-handle-geometry 	x-handle-iconic
x-handle-initial-switch 	x-handle-name-switch
x-handle-named-frame-geometry 	x-handle-no-bitmap-icon
x-handle-numeric-switch 	x-handle-parent-id
x-handle-reverse-video 	x-handle-smid
x-handle-switch 	x-handle-xrm-switch
x-hide-tip 	x-initialize-window-system
x-list-fonts 	x-menu-bar-open
x-menu-bar-open-internal 	x-must-resolve-font-name
x-open-connection 	x-own-selection-internal
x-parse-geometry 	x-popup-dialog
x-popup-menu 	x-register-dnd-atom
x-resolve-font-name 	x-select-font
x-select-text 	x-selection
x-selection-exists-p 	x-selection-owner-p
x-selection-value 	x-selection-value-internal
x-send-client-message 	x-server-max-request-size
x-server-vendor 	x-server-version
x-set-selection 	x-setup-function-keys
x-show-tip 	x-synchronize
x-uses-old-gtk-dialog 	x-valid-simple-selection-p
x-win-suspend-error 	x-window-property
x-wm-set-size-hint 	xdb
xml-find-file-coding-system 	xml-mode
xml-parse-file 	xml-parse-region
xmltok-get-declared-encoding-position 	xselect--encode-string
xselect--int-to-cons 	xselect--selection-bounds
xselect-convert-to-atom 	xselect-convert-to-charpos
xselect-convert-to-class 	xselect-convert-to-colno
xselect-convert-to-delete 	xselect-convert-to-filename
xselect-convert-to-host 	xselect-convert-to-identity
xselect-convert-to-integer 	xselect-convert-to-length
xselect-convert-to-lineno 	xselect-convert-to-name
xselect-convert-to-os 	xselect-convert-to-save-targets
xselect-convert-to-string 	xselect-convert-to-targets
xselect-convert-to-user 	xterm-mouse-mode
xw-color-defined-p 	xw-color-values
xw-defined-colors 	xw-display-color-p
y-or-n-p 	y-or-n-p-with-timeout
yank 	yank-handle-category-property
yank-handle-font-lock-face-property 	yank-menu
yank-pop 	yank-rectangle
yenc-decode-region 	yenc-extract-filename
yes-or-no-p 	zap-to-char
zerop 	zlib-available-p
zlib-decompress-region 	zone
zone-mode 	zrgrep